border_size=1
usage=map

Mm^Xm       , Mm^Xm       , Mm^Xm       , Mm          , Mm          , Mm^Xm       , Mm          , Mm^Xm       , Mm^Xm       , Mm^Xm       , Mm^Xm       , Mm^Xm       , Mm          , Mm^Xm       , Mm^Xm       , Hh          , Mm          , Hh          , Hh          , Xv          , Mm          , Mm^Xm       , Mm^Xm       , Mm          , Mm^Xm       , Mm          , Xu          , Xu          , Xu          , Xu          , Xu          , Xu          , Xu          , Xu          , Xu
Mm          , Mm^Xm       , Mm          , Mm^Xm       , Mm          , Mm^Xm       , Mm          , Mm          , Mm^Xm       , Mm          , Mm^Xm       , Mm^Xm       , Mm          , Mm          , Mm^Xm       , Mm^Xm       , Mm          , Mm          , Hh          , Hh          , Hh          , Mm          , Hh          , Mm^Xm       , Mm          , Mm^Xm       , Mm          , Xu          , Mm^Xm       , Mm^Xm       , Mm          , Xu          , Xu          , Xu          , Xu
Mm^Xm       , Mm          , Mm          , Mm          , Mm          , Mm^Xm       , Ww          , Mm^Xm       , Ww          , Mm^Xm       , Mm          , Mm          , Mm          , Mm^Xm       , Mm^Xm       , Mm          , Hh          , Mm          , Hh          , Mm          , Hh          , Mm^Xm       , Mm          , Mm          , Hh          , Hh          , Mm^Xm       , Mm          , Hh          , Mm^Xm       , Hh          , Mm^Xm       , Mm          , Xu          , Xu
Mm^Xm       , Mm          , Mm          , Mm^Xm       , Mm^Xm       , Mm^Xm       , Mm          , Ww          , Mm          , Ww          , Mm          , Mm^Xm       , Mm          , Mm          , Mm          , Mm          , Mm          , Hh          , Mm^Vc       , Hh          , Hh          , Hh          , Hh          , Hh          , Mm          , Hh          , Hh          , Hh          , Gg          , Hh          , Mm^Xm       , Mm          , Mm^Xm       , Xu          , Xu
Mm          , Mm^Xm       , Mm          , Mm^Xm       , Mm          , Mm^Xm       , Mm          , Mm^Xm       , Mm          , Ww          , Ww          , Mm          , Mm          , Mm          , Mm          , Mm^Xm       , Mm          , Mm          , Hh          , Hh          , Hh          , Hh          , Hh          , Hh          , Mm^Vhh      , Hh          , Hh          , Gg          , Gg          , Hh^Fms      , Hh^Fds      , Mm^Xm       , Mm          , Mm^Xm       , Mm^Xm
Mm^Xm       , Mm          , Mm^Xm       , Mm^Xm       , Hh^Vc       , Hh          , Mm^Xm       , Mm          , Mm^Xm       , Hh          , Ww          , Mm^Xm       , Mm          , Hh          , Hh          , Mm          , Mm          , Hh          , Mm          , Hh          , Hh^Fp       , Mm          , Hh^Fds      , Hh          , Hh          , Mm          , Hh          , Gg^Efm         , Gg          , Gs^Fms      , Gs^Fms      , Hh          , Hh          , Mm          , Mm
Hh          , Mm^Xm       , Hh          , Hh          , Hh          , Mm          , Hh          , Hh          , Hh          , Hh          , Gg^Efm         , Ww          , Hh          , Mm^Xm       , Hh          , Hh          , Hh          , Hh          , Mm          , Hh          , Gs^Fds      , Hh^Fms      , Gs^Fms      , Gs^Fds      , Gg^Efm         , Hh          , Gg          , Hh          , Gg          , Mm          , Hh^Vhh      , Mm          , Ce          , Hh          , Rd
Mm^Xm       , Rd          , Mm          , Rd          , Re          , Hh          , Hh          , Mm          , Hh          , Gg          , Hh          , Ww          , Hh          , Hh          , Hh          , Mm          , Mm          , Hh          , Hh          , Mm          , Hh          , Gg          , Gg          , Gg          , Gg^Efm         , Gg          , Gg          , Hh          , Gg          , Gg          , Re          , Ce          , 1 Ke        , Rd          , Hh
Mm          , Mm^Xm       , Mm          , Mm          , Re          , Hh          , 2 Ke        , Ce          , Ce          , Gg^Efm         , Gg^Efm         , Ww          , Ww          , Hh          , Hh          , Mm          , Gg^Efm         , Hh          , Mm          , Hh          , Gg          , Gg          , Gg^Efm         , Hh          , Hh          , Gg^Efm         , Gg^Vh       , Gg^Efm         , Gg          , Gg^Efm         , Gs          , Ce          , Ce          , Gg^Efm         , Mm
Mm^Xm       , Mm^Xm       , Mm^Xm       , Mm          , Hh          , Ce          , Ce          , Ce          , Gs          , Hh          , Gg^Efm         , Ww          , Gs^Vht      , Ww          , Gg^Efm         , Gg          , Hh          , Gg          , Hh          , Gg          , Hh          , Gs^Vht      , Gg          , Gg^Efm         , Gg^Efm         , Gg          , Gg          , Gg          , Rd          , Rd          , Hh          , Gs^Fms      , Hh^Fp       , Mm          , Mm
Mm^Xm       , Mm          , Hh          , Mm          , Hh          , Rd          , Rd          , Gs          , Gs^Fms      , Gs          , Gg^Efm         , Ww          , Gg^Efm         , Ww          , Ww          , Hh          , Gg          , Hh          , Hh          , Gg          , Hh          , Hh          , Gg          , Gg          , Gs          , Gs          , Gg          , Rd          , Gg          , Hh          , Hh          , Hh^Fds      , Mm          , Mm          , Mm^Xm
Mm          , Hh          , Hh          , Hh          , Hh          , Mm          , Hh          , Gs^Fp       , Rd          , Gg          , Gs^Fms      , Ww          , Ww          , Ww          , Gg          , Ww          , Ww          , Hh          , Gg^Efm         , Gg          , Gg          , Gs          , Gg^Efm         , Gs          , Gs          , Rd          , Rd          , Rd          , Gg          , Hh          , Mm          , Hh          , Mm          , Mm          , Xu
Mm^Xm       , Hh          , Hh          , Mm^Vhh      , Mm          , Hh          , Gg          , Hh          , Rd          , Gs^Fds      , Gs^Fds      , Gs^Fds      , Gs          , Gg^Efm         , Gs^Fms      , Gg^Efm         , Ww          , Gg          , Hh^Vhh      , Hh^Fms      , Gs^Fp       , Gg^Efm         , Hh          , Rd          , Hh^Fms      , Hh          , Gs          , Gg^Efm         , Hh          , Hh          , Hh          , Hh          , Mm          , Xu          , Xu
Mm^Xm       , Mm          , Hh          , Hh          , Hh          , Hh          , Hh^Fds      , Gg          , Gs^Fms      , Gs^Fp       , Rd          , Rd          , Rd          , Gs^Fp       , Ss          , Ww          , Mm          , Hh          , Gg          , Gg^Efm         , Gg^Efm         , Gg          , Gs          , Rd          , Gs          , Gs^Fds      , Gg^Efm         , Hh^Vc       , Gg          , Hh          , Hh^Fds      , Mm          , Mm^Xm       , Xu          , Xu
Mm^Xm       , Mm^Xm       , Mm          , Mm          , Hh          , Mm          , Hh^Fms      , Gs^Fds      , Gs^Fms      , Gs^Fms      , Gs^Fds      , Gs^Fms      , Ss          , Rd          , Ss          , Ww          , Hh          , Hh          , Gg^Efm         , Gg          , Rd          , Rd          , Rd          , Rd          , Gs^Fms      , Gg          , Gg^Efm         , Gg^Efm         , Gg          , Gs^Fms      , Hh^Fds      , Mm          , Mm^Xm       , Xu          , Xu
Mm          , Mm          , Mm^Xm       , Mm          , Hh^Fms      , Hh          , Gg          , Gg^Efm         , Gs^Fds      , Gg^Vh       , Gs          , Gs^Fms      , Gg^Efm         , Ss          , Ww          , Ww          , Hh          , Gg          , Re          , Re          , Gg^Vc       , Gg^Efm         , Gs          , Gg          , Hh^Fds      , Hh^Fms      , Gg          , Gs^Fp       , Gg          , Gg^Efm         , Gs^Fp       , Hh          , Mm^Xm       , Mm          , Mm^Xm
Mm^Xm       , Mm          , Mm          , Hh          , Gs^Fms      , Gs^Fms      , Hh^Fds      , Gs^Fp       , Gg          , Gs^Fms      , Gs^Fms      , Gs^Fds      , Ww          , Ww          , Ww          , Rd          , Rd          , Rd          , Gs          , Gs          , Ww          , Gs^Fms      , Gs^Fds      , Gs^Fms      , Gs^Fp       , Gs^Fms      , Gs^Fms      , Gg          , Gg          , Hh          , Gs^Fms      , Mm          , Ww          , Ww          , Mm
Mm          , Mm          , Hh          , Hh          , Gg^Efm         , Hh^Fms      , Gs^Fms      , Gg^Efm         , Gg          , Gs          , Ss          , Ww          , Ww          , Ww          , Ww          , Ss          , Wwf         , Gg          , Gg          , Ww          , Gs^Fms      , Ww          , Gg^Efm         , Gs^Fms      , Gs^Fms      , Gs^Fms      , Gg          , Gg          , Gg          , Gg^Vh       , Mm          , Hh          , Ww          , Mm^Xm       , Mm^Xm
Mm          , Mm          , Hh          , Mm          , Gs^Fms      , Gs^Fms      , Gs^Fds      , Gs^Fms      , Wwf         , Ss          , Ww          , Ww          , Ww          , Ss          , Gs^Fds      , Ww          , Wwf         , Ww          , Ww          , Ww          , Gs^Fms      , Ww          , Ww          , Gs^Fms      , Gs^Fp       , Gs^Fds      , Gs^Fds      , Gs^Fms      , Gs^Fms      , Hh^Fms      , Hh^Fms      , Mm          , Ww          , Hh          , Hh
Hh          , Hh          , Gs^Fms      , Hh^Fms      , Gs^Fp       , Gg          , Ww          , Ww          , Gs          , Ww          , Gs^Fms      , Ww          , Ww^Vm       , Gg          , Gs          , Ss          , Rd          , Ss          , Gs          , Gs^Fms      , Gg^Efm         , Ww          , Ww          , Ww          , Ww          , Gs^Fp       , Gs^Fds      , Gs^Fds      , Gs^Fp       , Gs^Fds      , Gs^Fms      , Ww          , Gg          , Mm^Xm       , Gs^Fms
Mm          , Mm          , Hh          , Gs^Fds      , Gg          , Gg^Efm         , Ww          , Gg^Fet      , Gs^Fms      , Gs          , Wwf         , Ww          , Rd          , Rd          , Rd          , Gs^Vht      , Rd          , Gs          , Gs^Fp       , Gs^Fms      , Rd          , Gg          , Gg^Efm         , Gg          , Gg          , Ww          , Gg          , Gs^Vht      , Gs^Fms      , Gg^Efm         , Gs^Fms      , Ww          , Gg          , Gg^Efm         , Gg
Hh          , Hh          , Rd          , Gg          , Gs^Fms      , Gg^Efm         , Ww          , Gg^Vh       , Ww          , Ww          , Gs          , Gs^Fds      , Rd          , Gg^Efm         , Gs          , Gs          , Gs^Fds      , Gs^Fms      , Gg          , Gs^Fms      , Gs^Fms      , Gs          , Gs^Fms      , Gg^Efm         , Ww          , Ww          , Gs^Fms      , Gs          , Ww          , Gg          , Ww          , Ww          , Gg          , Gg          , Gg
Rd          , Rd          , Hh          , Rd          , Rd          , Rd          , Ww^Bw\      , Ww          , Gs^Fp       , Gg          , Rd          , Rd          , Gg          , Gg^Efm         , Gs^Fds      , Gs^Fp       , Gs^Fds      , Gg^Efm         , Gs^Fms      , Gs^Fp       , Gs^Fms      , Gs^Fms      , Rd          , Gs^Fms      , Gg          , Ww          , Ww          , Wwf         , Gs^Fms      , Ww          , Gg          , Gg^Efm         , Gs^Fms      , Gs^Fms      , Gg
Hh          , Hh^Fms      , Hh^Fds      , Gs^Fms      , Gg          , Ss          , Ww          , Ww^Bw\      , Rd          , Rd          , Rd          , Gs^Fms      , Gg          , Gg          , Gg          , Gg^Fet      , Gs^Fp       , Gs^Fp       , Gs^Fms      , Gs^Fms      , Gs^Fms      , Gs^Fds      , Gg          , Rd          , Gg^Vc       , Gg^Efm         , Ce          , Ce          , Gs^Fp       , Gs^Fms      , Gs^Fms      , Gs^Fp       , Gs^Fds      , Gg^Efm         , Gg
Hh          , Gs^Fms      , Gg          , Hh          , Gg^Efm         , Ss          , Ww          , Gs^Fms      , Ww          , Gs          , Gs^Fms      , Rd          , Gs^Fp       , Gs^Fms      , Gg^Efm         , Gs^Fms      , Gs^Fms      , Gs^Fds      , Gs^Fp       , Gs^Fms      , Gs^Fms      , Gs^Fds      , Gs^Fms      , Rd          , Gs          , Gs^Fms      , Ce          , 3 Ke        , Gg          , Gs^Fds      , Gg          , Gg^Efm         , Gs^Fds      , Gs^Fms      , Gg
Gg^Efm         , Gg          , Gs^Fds      , Gs^Fds      , Gs^Fms      , Ww          , Ww          , Ww          , Ww          , Ww          , Rd          , Rd          , Gs^Fms      , Gs^Fms      , Gs^Fms      , Gs^Fms      , Gs^Fms      , Gs^Fms      , Gs^Fms      , Gs^Fms      , Gs^Fms      , Gg^Efm         , Gg^Efm         , Gg          , Gg          , Rd          , Gg^Efm         , Gs^Fms      , Gg          , Gs^Fms      , Gg          , Gg^Efm         , Gg          , Gg          , Gg
