border_size=1
usage=map

Ms^Xm       , Ms^Xm       , Ms^Xm       , Ms^Xm       , Ms^Xm       , Ms^Xm       , Ms^Xm       , Ms^Xm       , Ms          , Ms          , Ms          , Ms          , Ms          , Ms          , Ms          , Ms^Xm       , Ms^Xm       , Ms^Xm       , Ms^Xm       , Ms^Xm       , Ms^Xm       , Ms          , Ms          , Ms          , Ms          , Ms          , Ms          , Ms          , Ms          , Ms          , Ms          , Ms          , Ms          , Ms^Xm       , Ms^Xm       , Ms^Xm       , Ms^Xm       , Ms^Xm       , Ms^Xm       , Ms^Xm       , Ms^Xm       , Ms^Xm       , Ms^Xm       , Ms^Xm
Ms^Xm       , Ms^Xm       , Ms^Xm       , Ms^Xm       , Ms^Xm       , Ms^Xm       , Ms^Xm       , Ms          , Ms          , Ms          , Ms          , Ms          , Ms          , Ms          , Ms          , Ms^Xm       , Ms^Xm       , Ms^Xm       , Ms^Xm       , Ms^Xm       , Ms^Xm       , Ms          , Ms          , Ms          , Mm          , Ms          , Ms          , Ms          , Ms          , Ms          , Ms          , Ms          , Ms          , Ms          , Ms          , Ms^Xm       , Ms          , Ms^Xm       , Ms          , Ms^Xm       , Ms          , Ms^Xm       , Ms^Xm       , Ms^Xm
Ms^Xm       , Ms^Xm       , Ms^Xm       , Ms^Xm       , Ms          , Ms^Xm       , Ms          , Ms          , Ms          , Ms          , Ms          , Ms          , Ms          , Ms          , Mm          , Mm          , Mm          , Ms          , Ms          , Ms^Xm       , Ms          , Ms          , Ms          , Ms          , Ha          , Mm          , Ms          , Mm          , Mm          , Ms          , Ms          , Mm          , Ms          , Ms          , Ms          , Ms          , Ha          , Ms          , Ms          , Ms          , Ms          , Ms          , Ms          , Ms
Ms^Xm       , Ms^Xm       , Ms          , Ms          , Ms          , Ms          , Ms          , Ms          , Ms          , Ms          , Ms          , Ms          , Ai          , Ms          , Mm          , Hh^Vhh      , Mm          , Ms          , Mm          , Ms          , Ms          , Ms          , Mm          , Ms          , Ha          , Ha          , Mm          , Mm          , Mm          , Ms          , Ms          , Mm          , Hh          , Mm          , Hh          , Ha          , Gg^Vc       , Ha          , Ha          , Ms          , Aa          , Ha          , Ha          , Ha
Ms^Xm       , Ms^Xm       , Ms          , Ms          , Ms          , Ms          , Ch          , Ms          , Mm          , Mm          , Mm          , Ms          , Ms          , Ai          , Ai          , Ai          , Ai          , Mm          , Mm          , Mm          , Mm          , Mm          , Mm          , Ms          , Ms          , Hh          , Hh          , Mm          , Mm          , Mm          , Hh          , Mm          , Gg          , Hh          , Gg          , Ha          , Rd          , Rd          , Aa          , Aa          , Ce          , Rd          , Aa          , Aa
Ms          , Ms          , Ms          , Ms          , Ch          , 2 Kh        , Ch          , Ms          , Mm          , Mm          , Ha          , Hh          , Hh          , Rd          , Aa          , Ha          , Ai          , Mm          , Mm          , Mm          , Mm          , Mm          , Hh          , Mm          , Ha          , Mm          , Hh          , Hh          , Hh          , Hh^Vhh      , Gg          , Hh          , Rd          , Rd          , Rd          , Aa          , Gg          , Ha          , Ha          , Ce          , 1 Ke        , Ce          , Ha          , Aa
Ms          , Ms          , Ms          , Mm          , Mm          , Ch          , Mm          , Mm          , Mm          , Ha^Vca      , Ms          , Mm          , Mm          , Ha          , Ha          , Rd          , Ww          , Mm          , Hh          , Hh          , Hh          , Hh          , Rd          , Hh          , Gg          , Hh          , Rd          , Rd          , Rd          , Rd          , Rd          , Rd          , Hh          , Hh          , Hh          , Hh          , Hh          , Hh          , Hh^Vc       , Ce          , Ce          , Ce          , Ms          , Ha
Ms          , Ms          , Ms          , Mm          , Mm          , Mm          , Mm          , Mm          , Mm          , Mm          , Ms          , Ms          , Mm          , Ms          , Ha          , Rd          , Rd          , Ww          , Ww          , Gg          , Rd          , Rd          , Hh          , Rd          , Rd          , Rd          , Aa          , Hh          , Mm          , Hh          , Hh          , Hh          , Mm          , Ha          , Ha          , Mm^Vhh      , Mm          , Mm          , Ms          , Ms          , Ms          , Ms          , Ms          , Ms
Ms          , Ms          , Ms          , Ms          , Mm^Vhh      , Mm          , Ms          , Mm          , Mm          , Mm          , Mm          , Mm          , Mm          , Ms          , Mm          , Hh          , Hh          , Rd          , Rd          , Wwf         , Gg          , Hh          , Mm          , Hh          , Hh          , Hh          , Ha          , Hh          , Hh          , Hh          , Ha          , Mm          , Ms          , Ms          , Ms          , Mm          , Mm          , Ms          , Ms          , Ms          , Ms          , Ms          , Ms          , Ms
Ms          , Ms          , Mm          , Mm          , Mm          , Mm          , Ms          , Ms          , Ha          , Mm          , Mm          , Mm          , Mm          , Mm          , Rd          , Rd          , Rd          , Rd          , Hh          , Ww          , Hh          , Hh          , Mm          , Hh^Vhh      , Ms          , Mm          , Ms          , Mm          , Mm          , Ha          , Ha          , Mm          , Ms          , Mm          , Ms          , Mm          , Ms          , Ms          , Ms^Xm       , Ms          , Ms^Xm       , Ms^Xm       , Ms^Xm       , Ms^Xm
Mm          , Mm          , Mm          , Ms          , Mm          , Mm          , Ms          , Ha          , Mm          , Mm          , Hh          , Hh          , Hh          , Gg^Vc       , Rd          , Hh          , Mm          , Mm          , Ha          , Ww          , Ww          , Hh          , Mm          , Ms          , Mm          , Ms          , Ms          , Ms          , Ms          , Ha          , Ha^Vca      , Ms          , Ms          , Ms          , Ms          , Ms          , Ms          , Ms          , Ms^Xm       , Ms^Xm       , Ms^Xm       , Ms^Xm       , Ms^Xm       , Ms^Xm
Ms          , Ms          , Ms          , Mm          , Mm          , Mm          , Ms          , Mm          , Mm          , Mm          , Mm          , Mm          , Hh          , Hh          , Rd          , Mm          , Ms          , Ms          , Ms          , Hh^Vc       , Hh          , Ww          , Ww          , Ww          , Ww          , Ms          , Ms          , Ms          , Ms          , Ms          , Ms          , Ms          , Ms          , Ms          , Ms          , Ms          , Ms          , Ms^Xm       , Ms^Xm       , Ms^Xm       , Ms^Xm       , Ms^Xm       , Ms^Xm       , Ms^Xm
Ms          , Mm          , Mm          , Mm          , Mm          , Ms          , Ha^Fma      , Ha^Fda      , Ha          , Hh          , Hh          , Hh          , Gs^Fmf      , Hh          , Rd          , Ha          , Mm          , Ha          , Mm          , Mm          , Mm          , Mm          , Mm          , Hh          , Ww          , Ha          , Ha          , Mm          , Mm          , Mm          , Mm          , Mm          , Ms          , Ms          , Ms          , Ms          , Ms          , Ms          , Ms          , Ms^Xm       , Ms^Xm       , Ms^Xm       , Ms^Xm       , Ms^Xm
Ms          , Mm          , Hh          , Mm          , Mm          , Ha^Fma      , Ha^Fda      , Hh^Fmf      , Hh          , Gs^Fmf      , Rd          , Gg          , Rd          , Rd          , Gg          , Hh          , Mm          , Mm          , Ms          , Mm          , Mm          , Mm          , Mm          , Mm          , Ha          , Ww          , Ww          , Hh          , Ww          , Hh          , Hh          , Ha          , Aa          , Mm          , Ha          , Ms          , Mm          , Ms          , Ms          , Ms          , Ms          , Ms          , Ms          , Ms^Xm
Mm          , Hh^Fdf      , Hh^Fdf      , Hh          , Hh^Fdf      , Hh          , Aa^Fda      , Hh^Fdf      , Gg          , Rd          , Gs^Fmf      , Rd          , Hh^Fmf      , Gg          , Hh          , Hh          , Hh          , Mm          , Mm          , Mm          , Ms          , Ms          , Ms          , Mm          , Ms          , Mm          , Ha          , Ww          , Mm          , Ww          , Ww          , Ww          , Ww          , Hh          , Ww          , Aa          , Ww          , Ms          , Ms          , Ms          , Ms          , Ms          , Ms          , Ms
Hh          , Hh^Fmf      , Hh^Fdf      , Hh^Fmf      , Gg          , Gs^Fmf      , Rd          , Rd          , Rd          , Rd          , Gs^Fmf      , Gs^Fdf      , Hh          , Hh          , Mm          , Mm          , Mm          , Mm          , Mm          , Ms          , Ms          , Ms          , Ms          , Ms          , Ms          , Ms          , Mm          , Mm          , Ms          , Mm          , Ms          , Mm          , Ms          , Ww          , Hh          , Ww          , Ms          , Ww          , Ww          , Ms          , Ms          , Ms          , Ms          , Ms
Gs^Fmf      , Gs^Fdf      , Gs^Fmf      , Gs^Fmf      , Gs^Fmf      , Hh          , Rd          , Gs^Fmf      , Gs^Fdf      , Gs^Fmf      , Hh^Fdf      , Hh          , Mm          , Mm          , Mm          , Ms^Vhha     , Ms          , Ms          , Mm          , Ms          , Ms          , Ms          , Ms          , Ms          , Ms          , Ms          , Ms          , Ms          , Ms^Xm       , Ms          , Ms^Xm       , Ms          , Mm          , Ms          , Mm          , Ms          , Ww          , Ms          , Ww          , Ms          , Ms          , Ms          , Ms          , Ms
Gs^Fdf      , Gs^Fmf      , Gg          , Gs^Fmf      , Rd          , Rd          , Gs^Fmf      , Gs^Fmf      , Gs^Fdf      , Hh^Fdf      , Hh          , Ha          , Ms          , Mm          , Ms          , Mm          , Mm          , Ha          , Mm          , Ms          , Ms          , Ms          , Ms          , Ms          , Ms          , Ms          , Ms          , Ms^Xm       , Ms^Xm       , Ms^Xm       , Ms^Xm       , Mm          , Mm          , Mm          , Ww          , Ww          , Ms          , Ww          , Ms          , Ms          , Ms          , Ms          , Ms          , Ms
Rd          , Rd          , Rd          , Rd          , Gs^Fdf      , Gs^Fmf      , Gs^Fmf      , Gg          , Hh^Fmf      , Hh^Fmf      , Ha^Fma      , Ha^Fda      , Ms          , Ms          , Ms          , Mm          , Ms          , Mm          , Mm          , Ms          , Ms          , Ms          , Ms          , Ms          , Ms          , Ms          , Ms          , Ms^Xm       , Ms^Xm       , Ms^Xm       , Ms^Xm       , Ms^Xm       , Ms^Xm       , Qxu         , Ms^Xm       , Ms^Xm       , Ms          , Ms          , Ms          , Ms          , Ms^Xm       , Ms^Xm       , Ms^Xm       , Ms^Xm
Gg^Efm         , Gg          , Gs^Fmf      , Gg          , Gs^Fmf      , Gs^Fmf      , Gs^Fdf      , Gs^Fmf      , Hh^Fdf      , Hh^Fdf      , Hh^Fmf      , Hh          , Mm          , Ha          , Mm          , Mm          , Ms          , Mm          , Ms          , Ms          , Ms          , Ms          , Ms          , Ms          , Ms          , Ms          , Ms          , Ms^Xm       , Ms^Xm       , Ms^Xm       , Ms^Xm       , Ms^Xm       , Ms^Xm       , Ms^Xm       , Ms^Xm       , Ms^Xm       , Ms^Xm       , Ms^Xm       , Ms^Xm       , Ms^Xm       , Ms^Xm       , Ms^Xm       , Ms^Xm       , Ms^Xm
Gs^Fmf      , Gg          , Gg          , Gs^Fmf      , Gs^Fdf      , Gg          , Gs^Fmf      , Hh^Fdf      , Hh^Fdf      , Hh          , Hh^Fdf      , Hh^Fdf      , Hh          , Mm          , Mm          , Mm          , Mm          , Mm          , Ms          , Ms          , Ms          , Ms          , Ms          , Ms          , Ms          , Ms          , Ms          , Ms^Xm       , Ms^Xm       , Ms^Xm       , Ms^Xm       , Ms^Xm       , Ms^Xm       , Ms^Xm       , Ms^Xm       , Ms^Xm       , Ms^Xm       , Ms^Xm       , Ms^Xm       , Ms^Xm       , Ms^Xm       , Ms^Xm       , Ms^Xm       , Ms^Xm
Gs^Fmf      , Gs^Fmf      , Gs^Fmf      , Gs^Fmf      , Gg          , Gg          , Gg          , Gs^Fmf      , Gs^Fdf      , Hh^Fmf      , Hh^Fdf      , Ms          , Hh          , Hh          , Mm          , Mm          , Ms          , Ms          , Ms          , Ms          , Ms          , Ms          , Ms          , Ms          , Ms          , Ms          , Ms          , Ms^Xm       , Ms^Xm       , Ms^Xm       , Ms^Xm       , Ms^Xm       , Ms^Xm       , Ms^Xm       , Ms^Xm       , Ms^Xm       , Ms^Xm       , Ms^Xm       , Ms^Xm       , Ms^Xm       , Ms^Xm       , Ms^Xm       , Ms^Xm       , Ms^Xm
