border_size=1
usage=map

Xu          , Xu          , Xu          , Uu          , Uu          , Uu          , Xu          , Xu          , Xu          , Xu          , Xu          , Xu          , Uh          , Uu          , Ur          , Uu          , Uu          , Xu          , Xu          , Xu          , Ww          , Xu          , Xu          , Xu          , Xu          , Xu          , Xu          , Xu          , Xu          , Xu          , Xu          , Xu          , Xu          , Xu          , Xu          , Xu          , Xu          , Xu
Xu          , Xu          , Xu          , Xu          , Uu          , Uu^Uf       , Uu          , Xu          , Xu          , Xu          , Xu          , Xu          , Uu^Uf       , Ur          , Ur          , Uh          , Uu          , Xu          , Xu          , Ww          , Xu          , Xu          , Xu          , Xu          , Xu          , Xu          , Xu          , Xu          , Xu          , Xu          , Xu          , Xu          , Xu          , Xu          , Xu          , Xu          , Xu          , Xu
Xu          , Xu          , Xu          , Xu          , Ur          , Uu          , Uu^Uf       , Xu          , Xu          , Xu          , Xu          , Xu          , Uu^Vu       , Ur          , Ur          , Ur          , Ur          , Uu^Uf       , Ww          , Ww          , Uu^Uf       , Uu^Uf       , Uu          , Uu          , Uh          , Xu          , Xu          , Xu          , Xu          , Xu          , Xu          , Xu          , Xu          , Xu          , Xu          , Xu          , Xu          , Xu
Xu          , Xu          , Xu          , Xu          , Uu          , Uu          , Uu          , Uh          , Uu          , Xu          , Uu^Uf       , Xu          , Uu          , Uh          , Ur          , Ur          , Uh          , Wwf         , Ur          , Ur          , Uu          , Uu          , Ur          , Uu^Uf       , Uh          , Uu          , Uu^Vud      , Xu          , Xu          , Xu          , Xu          , Xu          , Xu          , Xu          , Xu          , Xu          , Xu          , Xu
Xu          , Xu          , Xu          , Uh          , Uu^Uf       , Ur          , Uu          , Uh          , Uu          , Uu^Uf       , Uu          , Uu^Uf       , Uh          , Ur          , Ur          , Ur          , Uu          , Ww          , Uu^Vu       , Uh          , Xu          , Ur          , Xu          , Uu          , Ur          , Uu          , Uu          , Uu^Uf       , Uh          , Xu          , Cud         , Cud         , 4 Kud       , Xu          , Xu          , Xu          , Xu          , Xu
Xu          , Xu          , Uu^Uf       , Uu          , Uh          , Ur          , Ur          , Ur          , Ur          , Ur          , Ur          , Ur          , Ur          , Ur          , Wwf         , Ww          , Ww          , Ww          , Xu          , Xu          , Xu          , Xu          , Xu          , Xu          , Uu          , Uu          , Uu          , Uh          , Uu          , Uu          , Uu          , Cud         , Cud         , Xu          , Xu          , Xu          , Xu          , Xu
Xu          , Xu          , Uu^Uf       , Uu^Vu       , Uh          , Uh          , Ur          , Uu^Vud      , Xu          , Uu          , Uu^Uf       , Uu          , Ww          , Wwf         , Ur          , Uu^Uf       , Xu          , Xu          , Xu          , Xu          , Mm          , Mm          , Mm          , Xu          , Xu          , Uu^Uf       , Ur          , Uu^Uf       , Uu          , Uh          , Uu          , Uu^Uf       , Uh          , Xu          , Xu          , Xu          , Xu          , Xu
Xu          , Xu          , Uu          , Uu          , Uu          , Ur          , Cud         , Cud         , Cud         , Xu          , Xu          , Uu^Uf       , Ww          , Ur          , Ur          , Ur          , Uh          , Xu          , Xu          , Xu          , Mm          , Ww          , Ww          , Mm          , Xu          , Uh          , Uh          , Ur          , Ur          , Uu          , Uh          , Uu          , Uu          , Uu^Vu       , Uu^Uf       , Xu          , Xu          , Xu
Xu          , Xu          , Xu          , Uu          , Uu          , Ur          , Cud         , 2 Kud       , Cud         , Xu          , Xu          , Uu          , Ww          , Uh          , Ur          , Ur          , Ur          , Xu          , Xu          , Mm          , Mm          , Hh          , Ww          , Mm          , Mm^Xm       , Xu          , Xu          , Uu^Vud      , Uu^Uf       , Uu          , Xu          , Uu          , Uu          , Uu^Uf       , Uu          , Xu          , Xu          , Xu
Xu          , Xu          , Xu          , Uu^Uf       , Uu          , Ur          , Xu          , Cud         , Xu          , Xu          , Xu          , Uu^Uf       , Uu^Vud      , Ww          , Uu          , Ur          , Ur          , Ur          , Rr          , Cud         , Hh          , Ww          , Hh          , Mm          , Mm          , Xu          , Xu          , Uh          , Uu          , Ur          , Ur          , Xu          , Uu^Uf       , Uu          , Uu^Uf       , Uh          , Xu          , Xu
Xu          , Xu          , Xu          , Uh          , Ur          , Ur          , Xu          , Xu          , Xu          , Xu          , Xu          , Xu          , Xu          , Ww          , Ww          , Uh          , Uh^Dr       , Rr          , Rr          , Hh          , Gg          , Ww          , Ww          , Mm          , Mm^Vc       , Mm          , Xu          , Uu^Uf       , Uu^Vu       , Uh          , Uu          , Uu          , Uh          , Uu          , Uh          , Xu          , Xu          , Xu
Xu          , Xu          , Mm          , Uh^Dr       , Rr          , Uh^Dr       , Mm          , Mm          , Mm          , Xu          , Xu          , Xu          , Xu          , Xu          , Cud         , Ww          , Ww          , Rr          , Rr          , Rr          , Rd          , Gs^Fms      , Ww          , Hh^Fds      , Mm          , Mm          , Xu          , Xu          , Xu          , Uu          , Ur          , Uh          , Xu          , Uu^Uf       , Xu          , Xu          , Xu          , Xu
Mm^Xm       , Mm          , Hh          , Hh          , Rr          , Gs^Fds      , Hh^Fp       , Hh          , Mm          , Mm^Xm       , Mm^Xm       , Xu          , Mm^Xm       , Mm          , Hh          , Hd          , Ww          , Ww          , Ds          , Rr          , Rr          , Gs^Fds      , Ww          , Hh^Fds      , Hh^Fp       , Mm          , Mm^Xm       , Xu          , Xu          , Uh          , Ur          , Uu^Uf       , Xu          , Xu          , Xu          , Xu          , Xu          , Xu
Mm          , Mm          , Hh          , Hh^Fms      , Rr          , Hh^Fds      , Gs^Fds      , Hh^Vc       , Hh          , Mm          , Mm          , Mm^Xm       , Mm          , Mm          , Hh^Fp       , Hd          , Ww          , Ww          , Chw         , Rr          , Rr          , Ch          , Ww          , Gs^Fms      , Hh          , Mm          , Mm          , Mm^Xm       , Mm          , Uh^Dr       , Hh          , Ur          , Cud         , Xu          , Mm^Xm       , Xu          , Mm          , Xu
Hh^Fms      , Hh^Fp       , Hh^Fds      , Hh^Fp       , Gs^Fds      , Rr          , Gs^Fms      , Hh^Fms      , Hh^Fds      , Hh^Fms      , Mm          , Mm          , Hh^Fms      , Hh^Fds      , Gs^Fds      , Ss          , Ww          , Ww          , Chw         , 5 Kh        , Ch          , Wwf         , Rr          , Gg          , Gg          , Hh          , Mm          , Mm          , Mm          , Mm          , Hh          , Rr          , Hh          , Mm          , Mm          , Mm^Xm       , Mm          , Mm
Hh^Fms      , Gs^Fms      , Gs^Fms      , Hh^Fms      , Gs^Fds      , Rd          , Rd          , Gs^Fds      , Gs^Fms      , Hh          , Hh^Fms      , Hh^Fmw      , Gs^Fds      , Hh^Fms      , Gg          , Ss          , Ww          , Ww          , Ww^Vm       , Chw         , Ww          , Ww          , Gg          , Rr          , Rd          , Hh^Fds      , Hh          , Hh          , Hh          , Hh          , Gg          , Rr          , Gg^Vc       , Hh          , Hh          , Mm          , Hh          , Hh
Gs^Fds      , Gs^Fms      , Gg^Ve       , Gs^Fms      , Gg^Efm         , Gs^Fms      , Gs^Fms      , Rd          , Rd          , Gs^Fms      , Gs^Fms      , Gs^Fds      , Gs^Fp       , Gs^Fds      , Gs^Fms      , Gs^Fms      , Ww          , Ww          , Ww          , Ww          , Ww          , Ww          , Gg          , Gg^Wm       , Rr          , Gg          , Hh^Fp       , Mm          , Hh          , Gg          , Rr          , Rr          , Ce          , Hh          , Hh          , Hh          , Hh          , Hh
Gs^Fp       , Gs^Fds      , Gs^Fp       , Gs^Fmw      , Gs^Fms      , Gs^Fds      , Gs^Fp       , Gg^Ve       , Rd          , Cv          , Gg          , Gs^Fms      , Ww          , Ww          , Ww          , Ww          , Gg          , Ww          , Ds          , Ww          , Dd^Vda      , Ds          , Gg          , Rd          , Gg          , Rr          , Rd          , Hh^Fms      , Rd          , Gg          , Rd          , Ce          , 1 Ke        , Hh^Fds      , Gs^Fms      , Hh^Fds      , Gg          , Gg
Gs^Fds      , Gs^Fms      , Gs^Fms      , Gs^Fds      , Ww          , Ww          , Ww          , Ww          , Ww^Bw|      , Ww          , Ww          , Ww          , Rd          , Rd          , Rd          , Gs^Fds      , Rd          , Gs^Fms      , Rd          , Ds          , Rd          , Gs^Fms      , Rd          , Rd          , Gs^Fds      , Hh^Fds      , Hh^Fms      , Rd          , Gg          , Rr          , Rd          , Ce          , Ce          , Ce          , Gg          , Gs^Fms      , Gg          , Gs^Fms
Gs^Fp       , Gs^Fms      , Gg^Efm         , Ww          , Cv          , Cv          , Cv          , Gs^Fms      , Rd          , Gs^Fms      , Rd          , Rd          , Gg^Efm         , Gg^Ve       , Gg^Efm         , Rd          , Gs^Fmw      , Rd          , Cv          , Rd          , Gg          , Rd          , Gs^Fms      , Gs^Fp       , Gs^Fms      , Hh^Fms      , Gs^Fms      , Gs^Fms      , Gg^Ve       , Gs^Fms      , Gg          , Rd          , Rr          , Gs^Fms      , Gg          , Gs^Vht      , Gs^Fms      , Gg
Gs^Fds      , Gg^Ve       , Gs^Fds      , Ww          , Cv          , 3 Kv        , Cv          , Rd          , Gg          , Rd          , Gs^Fms      , Gs^Fds      , Gg          , Gg^Fet      , Gg^Efm         , Gs^Fds      , Gs^Fms      , Gs^Fms      , Gs^Fmw      , Gs^Fms      , Gs^Fms      , Gg^Efm         , Gs^Fmw      , Gs^Fms      , Gs^Fds      , Gs^Fds      , Gs^Fms      , Gs^Fms      , Gs^Fms      , Gs^Fms      , Gg^Efm         , Gg          , Rd          , Gg          , Rd          , Gg          , Gg          , Gg
Gs^Fms      , Gs^Fms      , Ww          , Ww          , Gg          , Cv          , Rd          , Rd          , Gs^Fms      , Gg^Ve       , Gs^Fms      , Gs^Fp       , Gs^Fds      , Gg^Efm         , Gs^Fds      , Gs^Fmw      , Gs^Fms      , Gg          , Gs^Fms      , Gs^Fds      , Gs^Fp       , Gs^Fds      , Gg^Ve       , Gs^Fms      , Gs^Fds      , Gs^Fp       , Gs^Fds      , Gs^Fms      , Gs^Fp       , Gg          , Gs^Fms      , Gs^Fms      , Gg^Efm         , Rd          , Gg          , Rd          , Rd          , Rd
Gg          , Gs^Fds      , Ww          , Gs^Fp       , Gs^Fds      , Rd          , Gs^Fds      , Gs^Fds      , Gs^Fms      , Gs^Fds      , Gs^Fds      , Gs^Fms      , Gs^Fms      , Gs^Fms      , Gs^Fms      , Gs^Fds      , Gg          , Gs^Fms      , Gg          , Gs^Fms      , Gs^Fds      , Gs^Fds      , Gs^Fds      , Gs^Fms      , Gs^Fms      , Gs^Fms      , Gs^Fds      , Gs^Fp       , Gs^Fds      , Gs^Fms      , Gs^Fds      , Gg          , Gs^Fds      , Gs^Fms      , Gs^Fds      , Gg          , Gg          , Gg
