Xu, Xu, Xu, Xu, Xu, Xu, Xu, Xu, Xu, Xu, Xu, Xu, Xu, Xu, Xu, Xu, Xu, Xu, Xu, Xu, Xu, Xu, Qxu, Qxu, Qxu, Qxu, Xu, Xu, Xu, Xu, Xu, Xu, Xu, Xu, Xu, Xu, Xu, Xu, Xu, Xu, Xu, Xu, Xu, Xu, Xu, Xu, Xu, Xu, Xu, Xu, Xu, Xu
Xu, Xu, Xu, Xu, Xu, Xu, Qxu, Xu, Uu, Uu, Uh, Uu, Uu, Xu, Qxu, Qxu, Qxu, Qxu, Qxu, Xu, Qxu, Qxu, Qxu, Qxu, Qxu, Qxu, Xu, Xu, Xu, Xu, Xu, Xu, Xu, Xu, Xu, Xu, Xu, Xu, Xu, Xu, Xu, Xu, Xu, Xu, Xu, Xu, Xu, Xu, Xu, Xu, Xu, Xu
Xu, Xu, Xu, Xu, Qxu, Qxu, Qxu, Uh, Uu, Uh, Uu, Tb^Tf, Uu, Uh, Uu, Tb^Tf, Uu, Uu, Uh, Qxu, Uu, Uu, Tb^Tf, Qxu, Qxu, Xu, Xu, Xu, Xu, Xu, Xu, Xu, Xu, Xu, Xu, Xu, Xu, Xu, Xu, Xu, Xu, Xu, Xu, Xu, Xu, Xu, Xu, Xu, 1 Cud, Xu, Xu, Xu
Xu, Xu, Xu, Xu, Qxu, Qxu, Qxu, Uu, Uh, Tb^Tf, Tb^Tf, Uh, Uu, Tb^Tf, Uu, Uh, Uu, Xu, Tb^Tf, Uh, Uu, Uu, Ur, Qxu, Qxu, Xu, Ur, Uh, Uu, Uu, Uh, Xu, Xu, Xu, Xu, Xu, Xu, Xu, Xu, Xu, Xu, Xu, Xu, Xu, Xu, Xu, Xu, Xu, Xu, Xu, Xu, Xu
Xu, Xu, Xu, Xu, Xu, Qxu, Qxu, Uh, Uh, Uu, Uu, Uu, Uu, Uh, Qxu, Uh, Uu, Uh, Uu, Uu, Uh, Uh, Qxu, Qxu^Bs\, Uu, Tb^Tf, Uu, Ur, Tb^Tf, Ur, Uu, Xu, Xu, Xu, Xu, Xu, Xu, Xu, Uh, Xu, Xu, Xu, Tb^Tf, Uh, Uu, Xu, Xu, Xu, Xu, Xu, Xu, Xu
Xu, Xu, Xu, Xu, Xu, Xu, Qxu, Qxu, Uu, Uh, Uu, Uh, Uu, Qxu, Qxu, Tb^Tf, Tb^Tf, Uu, Xu, Tb^Tf, Qxu, Qxu, Qxu, Uh, Ur, Uh, Uu, Uh, Uh, Uh, Xu, Ur, Uu, Xu, Xu, Xu, Tb^Tf, Tb^Tf, Uu, Uu^Vu, Tb^Tf, Xu, Uu, Uh, Uu, Tb^Tf, Uu, Tb^Tf, Tb^Tf, Xu, Xu, Xu
Xu, Xu, Xu, Xu, Xu, Xu, Tb^Tf, Uu, Tb^Tf, Uu, Uh, Tb^Tf, Uu, Uh, Uh, Qxu, Uh, Uu, Uh, Xu, Xu, Qxu, Qxu, Tb^Tf, Ur, Uu, Tb^Tf, Xu, Uu, Xu, Xu, Xu, Ur, Xu, Xu, Uh, Uu, Uu, Uh, Uu, Tb^Tf, Xu, Uu, Uu, Xu, Uh, Uh, Uu, Uh, Xu, Xu, Xu
Xu, Xu, Xu, Xu, Xu, Xu, Uh, Uu, Tb^Tf, Uu, Uu, Uu, Xu, Tb^Tf, Uu, Uu, Uh, Uu, Uh, Xu, Qxu, Qxu, Qxu, Xu, Uh, Ur, Uu, Xu, Xu, Uh, Xu, Xu, Xu, Uu, Ur, Uh, Tb^Tf, Uu, Uh, Uu, Uh, Uh, Uh, Uu, Xu, Uu, Tb^Tf, Uu, Uu, Xu, Xu, Xu
Uu, Xu, Xu, Xu, Xu, Uu, Uh, Uh, Uh, Qxu, Tb^Tf, Uu, Tb^Tf, Qxu, Qxu, Uu, Tb^Tf, Uu, Uu, Qxu, Qxu, Qxu, Qxu, Xu, Uh, Uu, Ur, Xu, Xu, Uu^Vu, Xu, Xu, Xu, Xu, Uh, Ur, Uh, Uu, Uu, Uu, Uh, Uh, Uu, Xu, Xu, Xu, Xu, Tb^Tf, Xu, Xu, Xu, Xu
Uu, Uh, Uh, Xu, Tb^Tf, Tb^Tf, Uh, Uh, Qxu, Qxu, Qxu, Uu, Uh, Tb^Tf, Uh, Uh, Tb^Tf, Uu, Uh, Qxu, Xu, Xu, Qxu, Qxu, Qxu, Tb^Tf, Ur, Uu, Uu, Xu, Xu, Xu, Xu, Uh, Tb^Tf, Ur, Xu, Xu, Xu, Uu, Xu, Uu, Ur, Uu, Ur, Xu, Xu, Xu, Xu, Xu, Xu, Xu
Xu, Tb^Tf, Uu, Uu, Uh, Uu, Uu, Qxu, Uh, Qxu, Qxu, Uh, Uu, Uu, Uu, Tb^Tf, Uu, Qxu, Qxu, Qxu, Qxu, Xu, Qxu, Qxu, Qxu, Tb^Tf, Uu, Uh, Uu, Xu, Uu, Xu, Ur, Uu, Ur, Ur, Xu, Xu, Tb^Tf, Xu, Ur, Ur, Xu, Ur, Xu, Uu, Xu, Xu, Xu, Xu, Xu, Xu
Xu, Xu, Xu, Uu, Uu, Uu, Qxu, Qxu, Tb^Tf, Uu, Xu, Xu, Xu, Xu, Xu, Xu, Xu, Xu, Xu, Qxu, Qxu, Xu, Xu, Qxu, Qxu, Xu, Ur, Uu, Ur, Ur, Uu, Ur, Ur, Ur, Ur, Tb^Tf, Ur, Uh, Ur, Uu, Xu, Xu, Uh, Xu, Ur, Uu, Xu, Xu, Xu, Xu, Xu, Xu
Xu, Xu, Xu, Xu, Tb^Tf, Uu, Uu, Uu, Uu, Uu, Xu, Xu, Xu, Xu, Xu, Xu, Xu, Xu, Xu, Qxu, Qxu, Xu, Qxu, Qxu, Qxu, Xu, Ur, Ur, Ur, Ur, Xu, Uu, Xu, Xu, Xu, Uu, Uu, Ur, Xu, Xu, Xu, Xu, Ur, Ur, Tb^Tf, Xu, Xu, Xu, Xu, Xu, Xu, Xu
Xu, Xu, Xu, Xu, Xu, Tb^Tf, Uh, Uh, Tb^Tf, Tb^Tf, Tb^Tf, Xu, Xu, Xu, Xu, Xu, Xu, Xu, Xu, Xu, Xu, Qxu, Qxu, Qxu, Qxu, Ur, egDC, egDC, Xu, Xu, Xu, Xu, Xu, Xu, Xu, Xu, Xu, Xu, Xu, Xu, Xu, Xu, Ur, Uh, Xu, Xu, Xu, Xu, Xu, Xu, Xu, Xu
Xu, Xu, Xu, Xu, Xu, Xu, Uu, Uu^Vu, Tb^Tf, Tb^Tf, Uu^Vu, Tb^Tf, Tb^Tf, Xu, Xu, Xu, Xu, Xu, Xu, Xu, Xu, Qxu, Qxu, Qxu, Uh, Ur, egDC, egDK, Xu, Xu, Xu, Xu, Xu, Xu, Xu, Xu, Xu, Xu, Xu, Xu, Xu, Xu, Tb^Tf, Uu, Xu, Xu, Xu, Xu, Xu, Xu, Xu, Xu
Xu, Xu, Xu, Xu, Xu, Xu, Ch, Uu, Uu, Tb^Tf, Tb^Tf, Tb^Tf, Tb^Tf, Xu, Xu, Xu, Xu, Xu, Xu, Xu, Qxu, Qxu, Qxu, Qxu, Uh, Ur, Uu^Vu, egDC, Xu, Xu, Xu, Xu, Xu, Xu, Xu, Xu, Xu, Xu, Xu, Xu, Xu, Xu, Tb^Tf, Ur, Uu, Uh, Xu, Xu, Xu, Xu, Xu, Xu
Xu, Xu, Xu, Xu, Ch, 2 Kh, Chr, Uh, Uu, Uh, Uu, Xu, Xu, Xu, Xu, Xu, Xu, Xu, Xu, Xu, Qxu, Qxu, Qxu, Qxu, Tb^Tf, Ur, Ur, Xu, Xu, Xu, Xu, Xu, Xu, Xu, Xu, Xu, Xu, Xu, Xu, Xu, Xu, Xu, Xu, Xu, Xu, Uu, Uh, Xu, Xu, Xu, Xu, Xu
Xu, Xu, Xu, Xu, Xu, Chr, Uu^Vu, Tb^Tf, Uu, Uh, Uh, Qxu, Xu, Xu, Xu, Xu, Xu, Xu, Xu, Xu, Xu, Qxu, Qxu, Xu, Uu, Uu, Ur, Xu, Xu, Xu, Xu, Xu, Xu, Xu, Xu, Xu, Xu, Xu, Xu, Xu, Xu, Xu, Xu, Xu, Xu, Ur, Uh, Xu, Xu, Xu, Xu, Xu
Xu, Xu, Xu, Xu, Uh, Xu, Uh, Uu, Uu, Uh, Qxu, Qxu, Qxu, Xu, Uh, Uu, Tb^Tf, Xu, Xu, Xu, Xu, Qxu, Qxu, Xu, Tb^Tf, Uh, Ur, Tb^Tf, Tb^Tf, Xu, Xu, Xu, Xu, Xu, Xu, Xu, Xu, Xu, Xu, Xu, Xu, Xu, Ur, Xu, Ur, Ur, Uu, Xu, Uu, Xu, Xu, Xu
Uu, Xu, Uh, Uu, Ur, Uu, Uu, Uu, Xu, Xu, Qxu, Qxu, Qxu, Qxu, Tb^Tf, Uu, Uh, Uh, Xu, Xu, Qxu, Qxu, Uu, Qxu, Qxu^Bs/, Ur, Uh, Uh, Uu, Xu, Xu, Xu, Xu, Xu, Xu, Xu, Xu, Xu, Xu, Xu, egDC, Ur, Uh, Uu, Uh, Tb^Tf, Xu, Uh, Xu, Uh, Xu, Xu
Uu, Ur, Uu, Ur, Xu, Uu, Uu, Uh, Xu, Xu, Qxu, Qxu, Qxu, Qxu, Qxu, Tb^Tf, Uu, Uu, Xu, Xu, Uh, Tb^Tf, Ur, Uu, Qxu, Qxu, Qxu, Qxu, Xu, Xu, Xu, Xu, Xu, Xu, Xu, Xu, Xu, Xu, Xu, Ur, Ur, Ur, Xu, Xu, Xu, Xu, Xu, Xu, Xu, Uu, Uu^Vu, Xu
Xu, Uh, Xu, Xu, Xu, Uu, Uh, Uu, Uh, Xu, Qxu, Qxu, Qxu, Qxu, Qxu, Xu, Tb^Tf, Uu, Uu, Uh, Uh, Ur, Uh, Uh, Qxu, Qxu, Qxu, Qxu, Xu, Xu, Xu, Xu, Xu, Xu, Xu, Xu, Xu, Xu, Uh^Em, Ur, Ur, Xu, Xu, Xu, Xu, Xu, Xu, Xu, Xu, Xu, Xu, Xu
Xu, Xu, Xu, Xu, Xu, Xu, Uh, Uu, Tb^Tf, Xu, Xu, Qxu, Qxu, Qxu, Uh, Uu, Uh, Uh, Uu, Uu, Uu, Uu, Xu, Xu, Xu, Qxu, Qxu, Qxu, Qxu, Xu, Xu, Xu, Xu, Xu, Xu, Xu, Uh^Em, Uu^Emf, Ur, Ur, Ur, Xu, Ss, Xu, Sm^Ewl, Xu, Xu, Xu, Xu, Xu, Xu, Xu
Xu, Xu, Xu, Xu, Xu, Xu, Tb^Tf, Uu, Uu, Tb^Tf, Qxu, Qxu, Xu, Xu, Uu, Uu, Tb^Tf, Uu, Xu, Tb^Tf, Uu, Uh, Qxu, Xu, Xu, Xu, Qxu, Qxu, Qxu, Xu, Xu, Xu, Urb, Xu, Urb, Xu, Ur, Ur, Ur, Ur, Tb^Tf, Ss^Vm, Ss, Ss, Ww, Ww, Ww, Xu, Xu, Xu, Xu, Xu
Xu, Xu, Xu, Xu, Tb^Tf, Xu, Uu, Uh, Uu, Uu, Qxu, Qxu, Tb^Tf, Tb^Tf, Uu, Tb^Tf, Uh, Uh, Uu, Tb^Tf, Uh, Uu, Qxu, Qxu, Qxu, Qxu, Qxu, Qxu, Xu, Xu, Xu, Xu, Urb, Urb, Urb, Urb, Ur, Ur, Ur, Tb^Tf, Tb^Tf, Tb^Tf, Ww, Ww, Wwg, Wwg, Ww, Xu, Xu, Xu, Xu, Xu
Xu, Xu, Xu, Xu, Uh, Uu, Uh, Tb^Tf, Uh, Qxu, Qxu, Uu, Uh, Uu, Uh, Uu, Uu, Uh, Uu, Uu, Uu, Uu, Uh, Qxu, Qxu, Qxu, Qxu, Qxu, Xu, Xu, Xu, Xu, Urb, Urb, Urb, Urb, Uu^Vud, Ur, Ur, Tb^Tf, Tb^Tf, Tb^Tf, Ww, Wwg, Wwg, Wwg, Ww, Xu, Xu, Xu, Xu, Xu
Xu, Xu, Xu, Xu, Xu, Tb^Tf, Tb^Tf, Tb^Tf, Uu, Qxu, Qxu, Uu, Uu, Tb^Tf, Xu, Tb^Tf, Uu, Uu, Qxu, Uu, Tb^Tf, Tb^Tf, Uh, Qxu, Qxu, Qxu, Qxu, Xu, Xu, Xu, Xu, Xu, Xu, Xu, Xu, Xu, egDK, Uh^Em, Ur, Ur, Ur, Uu^Vud, Xu, Ww, Ww, Ww, Xu, Xu, Xu, Xu, Xu, Xu
Xu, Xu, Xu, Xu, Xu, Xu, Uh, Uu, Uu, Tb^Tf, Uh, Uh, Uu, Uh, Uh, Uh, Uh, Uu, Qxu, Xu, Uh, Uu, Tb^Tf, Xu, Xu, Qxu, Qxu, Xu, Xu, Xu, Xu, Xu, Xu, Xu, Xu, Xu, Xu, egDC, Xu, Ur, Ur, Tb^Tf, Xu, Xu, Ww, Ww, Xu, Xu, Xu, Xu, Xu, Xu
Xu, Xu, Xu, Xu, Xu, Xu, Tb^Tf, Uu, Uu, Tb^Tf, Uh, Uu, Xu, Uu, Tb^Tf, Tb^Tf, Uu, Tb^Tf, Uu, Xu, Uu, Uh, Uh, Xu, Xu, Qxu, Qxu, Qxu, Xu, Xu, Xu, Xu, Xu, Xu, Xu, Xu, Xu, Xu, egDC, Ur, Ur, Tb^Tf, Xu, Ww, Xu, Xu, Xu, Xu, Xu, Xu, Xu, Xu
Xu, Xu, Xu, Xu, Xu, Xu, Qxu, Qxu, Qxu, Uu, Uh, Xu, Xu, Uh, Uu, Uh, Uh, Uh, Uu, Tb^Tf, Uh, Uh, Xu, Xu, Xu, Qxu, Qxu, Qxu, Xu, Xu, Xu, Xu, Xu, Xu, Xu, Xu, Xu, Xu, Ur, Ur, Uu, Xu, Xu, Ww, Ww, Xu, Xu, Xu, Wo, Xu, Xu, Xu
Xu, Xu, Xu, Xu, Qxu, Qxu, Qxu, Xu, Xu, Tb^Tf, Uu, Uu, Tb^Tf, Tb^Tf, Uh, Uu, Uu, Uh, Uu, Tb^Tf, Tb^Tf, Xu, Xu, Xu, Xu, Qxu, Qxu, Qxu, Xu, Xu, Xu, Xu, Xu, Xu, Xu, Xu, Ur, Ur, Xu, Xu, Qxu, Xu, Qxu, Xu, Xu, Ww, Wo, Wo, Wo, Wo, Xu, Xu
Xu, Xu, Xu, Qxu, Qxu, Qxu, Qxu, Xu, Xu, Uh, Uu, Uh, Uu, Uu, Uu, Uu, Tb^Tf, Uh, Xu, Uh, Xu, Xu, Xu, Xu, Xu, Qxu, Qxu, Qxu, Qxu, Qxu, Qxu, Qxu, Xu, Xu, Xu, Xu, Uu, Qxu, Qxu, Qxu, Qxu, Qxu, Qxu, Xu, Wwr, Xu, Ww, Ww, Ww, Xu, Xu, Xu
Xu, Xu, Xu, Qxu, Qxu, Qxu, Qxu, Xu, Xu, Uh, Uu, Tb^Tf, Tb^Tf, Uh, Tb^Tf, Uu, Uu, Xu, Xu, Xu, Xu, Xu, Xu, Xu, Xu, Xu, Qxu, Qxu, Qxu, Qxu, Qxu, Xu, Xu, Xu, Xu, Ur, Qxu, Qxu, Qxu, Qxu, Ur, Qxu, Qxu, Wwr, Qxu, Wwr, Wwr, Wwr, Xu, Xu, Xu, Xu
Xu, Xu, Xu, Xu, Xu, Qxu, Xu, Xu, Xu, Xu, Uu, Uu, Uh, Uh, Tb^Tf, Uh, Uu, Xu, Xu, Xu, Xu, Xu, Xu, Xu, Xu, Xu, Xu, Qxu, Xu, Qxu, Qxu, Qxu, Qxu, Xu, Xu, Ur, Qxu^Bs\, Qxu, Ur, Ur, Xu, Uu, Xu, Qxu, Qxu, Wwr, Uu, Uu, Xu, Xu, Xu, Xu
Xu, Xu, Xu, Xu, Xu, Xu, Xu, Xu, Xu, Xu, Xu, Uh, Tb^Tf, Uu, Uh, Uu, Uu, Xu, Xu, Xu, Xu, Xu, Xu, Xu, Xu, Xu, Xu, Xu, Xu, Qxu, Qxu, Qxu, Qxu, Qxu, Qxu, Qxu, Qxu, Ur, Xu, Xu, Tb^Tf, Ur, Ur, Xu, Xu, Xu, Uu, Tb^Tf, Xu, Xu, Xu, Xu
Xu, Xu, Xu, Xu, Xu, Xu, Xu, Xu, Xu, Xu, Xu, Xu, Xu, Uh, Xu, Xu, Xu, Xu, Xu, Xu, Xu, Xu, Xu, Xu, Xu, Xu, Xu, Xu, Xu, Xu, Xu, Qxu, Qxu, Qxu, Qxu, Qxu, Qxu, Tb^Tf, Xu, Xu, Xu, Uh, Xu, Uu, Ur, Uh, Uu, Uh, Xu, Xu, Xu, Xu
Xu, Xu, Xu, Xu, Xu, Xu, Xu, Xu, Xu, Xu, Xu, Xu, Xu, Xu, Xu, Xu, Xu, Xu, Xu, Xu, Xu, Xu, Xu, Xu, Xu, Xu, Xu, Xu, Xu, Xu, Xu, Xu, Xu, Qxu, Xu, Qxu, Qxu, Qxu, Qxu, Xu, Qxu, Xu, Xu, Xu, Xu, Ur, Uu, Xu, Xu, Xu, Xu, Xu
Xu, Xu, Xu, Xu, Xu, Xu, Xu, Xu, Xu, Xu, Xu, Xu, Xu, Xu, Xu, Xu, Xu, Xu, Xu, Xu, Xu, Xu, Xu, Xu, Xu, Xu, Xu, Xu, Xu, Xu, Xu, Xu, Xu, Xu, Xu, Qxu, Xu, Qxu, Qxu, Qxu, Qxu, Xu, Xu, Xu, Xu, Ur, Ur^Dr, Uu^Dr, Xu, Xu, Xu, Xu
Xu, Xu, Xu, Xu, Xu, Xu, Xu, Xu, Xu, Xu, Xu, Xu, Xu, Xu, Xu, Xu, Xu, Xu, Xu, Xu, Xu, Xu, Xu, Xu, Xu, Xu, Xu, Xu, Xu, Xu, Xu, Xu, Xu, Xu, Xu, Xu, Xu, Xu, Xu, Qxu, Qxu, Qxu, Qxu, Xu, Xu, Xu, Xu, Uu^Dr, Xu, Xu, Xu, Xu
Xu, Xu, Xu, Xu, Xu, Xu, Xu, Xu, Xu, Xu, Xu, Xu, Xu, Xu, Xu, Xu, Xu, Xu, Xu, Xu, Xu, Xu, Xu, Xu, Xu, Xu, Xu, Xu, Xu, Xu, Xu, Xu, Xu, Xu, Xu, Xu, Xu, Xu, Xu, Xu, Xu, Qxu, Qxu, Qxu, Xu, Xu, Xu, Xu, Qxu, Xu, Qxu, Qxu
Xu, Xu, Xu, Xu, Xu, Xu, Xu, Xu, Xu, Xu, Xu, Xu, Xu, Xu, Xu, Xu, Xu, Xu, Xu, Xu, Xu, Xu, Xu, Xu, Xu, Xu, Xu, Xu, Xu, Xu, Xu, Xu, Xu, Xu, Xu, Xu, Xu, Xu, Xu, Xu, Xu, Qxu, Qxu, Qxu, Xu, Xu, Xu, Xu, Qxu, Qxu, Qxu, Qxu
