border_size=1
usage=map

Xu          , Xu          , Xu          , Xu          , Xu          , Xu          , Xu          , Xu          , Xu          , Xu          , Xu          , Xu          , Xu          , Xu          , Xu          , Xu          , Xu          , Xu          , Xu          , Xu          , Xu          , Xu          , Qxu         , Qxu         , Qxu         , Qxu         , Xu          , Xu          , Xu          , Xu          , Xu          , Xu          , Xu          , Xu          , Xu          , Xu          , Xu          , Xu          , Xu          , Xu          , Xu          , Xu          , Xu          , Xu          , Xu          , Xu          , Xu          , Xu          , Xu          , Xu          , Xu          , Xu
Xu          , Xu          , Xu          , Xu          , Xu          , Xu          , Qxu         , Xu          , Uu          , Uu          , Uh          , Uu          , Uu          , Xu          , Qxu         , Qxu         , Qxu         , Qxu         , Qxu         , Xu          , Qxu         , Qxu         , Qxu         , Qxu         , Qxu         , Qxu         , Xu          , Xu          , Xu          , Xu          , Xu          , Xu          , Xu          , Xu          , Xu          , Xu          , Xu          , Xu          , Xu          , Xu          , Xu          , Xu          , Xu          , Xu          , Xu          , Xu          , Xu          , Xu          , Xu          , Xu          , Xu          , Xu
Xu          , Xu          , Xu          , Xu          , Qxu         , Qxu         , Qxu         , Uh          , Uu          , Uh          , Uu          , Uu^Uf       , Uu          , Uh          , Uu          , Uu^Uf       , Uu          , Uu          , Uh          , Qxu         , Uu          , Uu          , Uu^Uf       , Qxu         , Qxu         , Xu          , Xu          , Xu          , Xu          , Xu          , Xu          , Xu          , Xu          , Xu          , Xu          , Xu          , Xu          , Xu          , Xu          , Xu          , Xu          , Xu          , Xu          , Xu          , Xu          , Xu          , Xu          , Xu          , 1 Cud       , Xu          , Xu          , Xu
Xu          , Xu          , Xu          , Xu          , Qxu         , Qxu         , Qxu         , Uu          , Uh          , Uu^Uf       , Uu^Uf       , Uh          , Uu          , Uu^Uf       , Uu          , Uh          , Uu          , Xu          , Uu^Uf       , Uh          , Uu          , Uu          , Ur          , Qxu         , Qxu         , Xu          , Ur          , Uh          , Uu          , Uu          , Uh          , Xu          , Xu          , Xu          , Xu          , Xu          , Xu          , Xu          , Xu          , Xu          , Xu          , Xu          , Xu          , Xu          , Xu          , Xu          , Xu          , Xu          , Xu          , Xu          , Xu          , Xu
Xu          , Xu          , Xu          , Xu          , Xu          , Qxu         , Qxu         , Uh          , Uh          , Uu          , Uu          , Uu          , Uu          , Uh          , Qxu         , Uh          , Uu          , Uh          , Uu          , Uu          , Uh          , Uh          , Qxu         , Qxu^Bs\     , Uu          , Uu^Uf       , Uu          , Ur          , Uu^Uf       , Ur          , Uu          , Xu          , Xu          , Xu          , Xu          , Xu          , Xu          , Xu          , Uh          , Xu          , Xu          , Xu          , Uu^Uf       , Uh          , Uu          , Xu          , Xu          , Xu          , Xu          , Xu          , Xu          , Xu
Xu          , Xu          , Xu          , Xu          , Xu          , Xu          , Qxu         , Qxu         , Uu          , Uh          , Uu          , Uh          , Uu          , Qxu         , Qxu         , Uu^Uf       , Uu^Uf       , Uu          , Xu          , Uu^Uf       , Qxu         , Qxu         , Qxu         , Uh          , Ur          , Uh          , Uu          , Uh          , Uh          , Uh          , Xu          , Ur          , Uu          , Xu          , Xu          , Xu          , Uu^Uf       , Uu^Uf       , Uu          , Uu^Vu       , Uu^Uf       , Xu          , Uu          , Uh          , Uu          , Uu^Uf       , Uu          , Uu^Uf       , Uu^Uf       , Xu          , Xu          , Xu
Xu          , Xu          , Xu          , Xu          , Xu          , Xu          , Uu^Uf       , Uu          , Uu^Uf       , Uu          , Uh          , Uu^Uf       , Uu          , Uh          , Uh          , Qxu         , Uh          , Uu          , Uh          , Xu          , Xu          , Qxu         , Qxu         , Uu^Uf       , Ur          , Uu          , Uu^Uf       , Xu          , Uu          , Xu          , Xu          , Xu          , Ur          , Xu          , Xu          , Uh          , Uu          , Uu          , Uh          , Uu          , Uu^Uf       , Xu          , Uu          , Uu          , Xu          , Uh          , Uh          , Uu          , Uh          , Xu          , Xu          , Xu
Xu          , Xu          , Xu          , Xu          , Xu          , Xu          , Uh          , Uu          , Uu^Uf       , Uu          , Uu          , Uu          , Xu          , Uu^Uf       , Uu          , Uu          , Uh          , Uu          , Uh          , Xu          , Qxu         , Qxu         , Qxu         , Xu          , Uh          , Ur          , Uu          , Xu          , Xu          , Uh          , Xu          , Xu          , Xu          , Uu          , Ur          , Uh          , Uu^Uf       , Uu          , Uh          , Uu          , Uh          , Uh          , Uh          , Uu          , Xu          , Uu          , Uu^Uf       , Uu          , Uu          , Xu          , Xu          , Xu
Uu          , Xu          , Xu          , Xu          , Xu          , Uu          , Uh          , Uh          , Uh          , Qxu         , Uu^Uf       , Uu          , Uu^Uf       , Qxu         , Qxu         , Uu          , Uu^Uf       , Uu          , Uu          , Qxu         , Qxu         , Qxu         , Qxu         , Xu          , Uh          , Uu          , Ur          , Xu          , Xu          , Uu^Vu       , Xu          , Xu          , Xu          , Xu          , Uh          , Ur          , Uh          , Uu          , Uu          , Uu          , Uh          , Uh          , Uu          , Xu          , Xu          , Xu          , Xu          , Uu^Uf       , Xu          , Xu          , Xu          , Xu
Uu          , Uh          , Uh          , Xu          , Uu^Uf       , Uu^Uf       , Uh          , Uh          , Qxu         , Qxu         , Qxu         , Uu          , Uh          , Uu^Uf       , Uh          , Uh          , Uu^Uf       , Uu          , Uh          , Qxu         , Xu          , Xu          , Qxu         , Qxu         , Qxu         , Uu^Uf       , Ur          , Uu          , Uu          , Xu          , Xu          , Xu          , Xu          , Uh          , Uu^Uf       , Ur          , Xu          , Xu          , Xu          , Uu          , Xu          , Uu          , Ur          , Uu          , Ur          , Xu          , Xu          , Xu          , Xu          , Xu          , Xu          , Xu
Xu          , Uu^Uf       , Uu          , Uu          , Uh          , Uu          , Uu          , Qxu         , Uh          , Qxu         , Qxu         , Uh          , Uu          , Uu          , Uu          , Uu^Uf       , Uu          , Qxu         , Qxu         , Qxu         , Qxu         , Xu          , Qxu         , Qxu         , Qxu         , Uu^Uf       , Uu          , Uh          , Uu          , Xu          , Uu          , Xu          , Ur          , Uu          , Ur          , Ur          , Xu          , Xu          , Uu^Uf       , Xu          , Ur          , Ur          , Xu          , Ur          , Xu          , Uu          , Xu          , Xu          , Xu          , Xu          , Xu          , Xu
Xu          , Xu          , Xu          , Uu          , Uu          , Uu          , Qxu         , Qxu         , Uu^Uf       , Uu          , Xu          , Xu          , Xu          , Xu          , Xu          , Xu          , Xu          , Xu          , Xu          , Qxu         , Qxu         , Xu          , Xu          , Qxu         , Qxu         , Xu          , Ur          , Uu          , Ur          , Ur          , Uu          , Ur          , Ur          , Ur          , Ur          , Uu^Uf       , Ur          , Uh          , Ur          , Uu          , Xu          , Xu          , Uh          , Xu          , Ur          , Uu          , Xu          , Xu          , Xu          , Xu          , Xu          , Xu
Xu          , Xu          , Xu          , Xu          , Uu^Uf       , Uu          , Uu          , Uu          , Uu          , Uu          , Xu          , Xu          , Xu          , Xu          , Xu          , Xu          , Xu          , Xu          , Xu          , Qxu         , Qxu         , Xu          , Qxu         , Qxu         , Qxu         , Xu          , Ur          , Ur          , Ur          , Ur          , Xu          , Uu          , Xu          , Xu          , Xu          , Uu          , Uu          , Ur          , Xu          , Xu          , Xu          , Xu          , Ur          , Ur          , Uu^Uf       , Xu          , Xu          , Xu          , Xu          , Xu          , Xu          , Xu
Xu          , Xu          , Xu          , Xu          , Xu          , Uu^Uf       , Uh          , Uh          , Uu^Uf       , Uu^Uf       , Uu^Uf       , Xu          , Xu          , Xu          , Xu          , Xu          , Xu          , Xu          , Xu          , Xu          , Xu          , Qxu         , Qxu         , Qxu         , Qxu         , Ur          , egDC        , egDC        , Xu          , Xu          , Xu          , Xu          , Xu          , Xu          , Xu          , Xu          , Xu          , Xu          , Xu          , Xu          , Xu          , Xu          , Ur          , Uh          , Xu          , Xu          , Xu          , Xu          , Xu          , Xu          , Xu          , Xu
Xu          , Xu          , Xu          , Xu          , Xu          , Xu          , Uu          , Uu^Vu       , Uu^Uf       , Uu^Uf       , Uu^Vu       , Uu^Uf       , Uu^Uf       , Xu          , Xu          , Xu          , Xu          , Xu          , Xu          , Xu          , Xu          , Qxu         , Qxu         , Qxu         , Uh          , Ur          , egDC        , egDK        , Xu          , Xu          , Xu          , Xu          , Xu          , Xu          , Xu          , Xu          , Xu          , Xu          , Xu          , Xu          , Xu          , Xu          , Uu^Uf       , Uu          , Xu          , Xu          , Xu          , Xu          , Xu          , Xu          , Xu          , Xu
Xu          , Xu          , Xu          , Xu          , Xu          , Xu          , Ch          , Uu          , Uu          , Uu^Uf       , Uu^Uf       , Uu^Uf       , Uu^Uf       , Xu          , Xu          , Xu          , Xu          , Xu          , Xu          , Xu          , Qxu         , Qxu         , Qxu         , Qxu         , Uh          , Ur          , Uu^Vu       , egDC        , Xu          , Xu          , Xu          , Xu          , Xu          , Xu          , Xu          , Xu          , Xu          , Xu          , Xu          , Xu          , Xu          , Xu          , Uu^Uf       , Ur          , Uu          , Uh          , Xu          , Xu          , Xu          , Xu          , Xu          , Xu
Xu          , Xu          , Xu          , Xu          , Ch          , 2 Kh        , Chr         , Uh          , Uu          , Uh          , Uu          , Xu          , Xu          , Xu          , Xu          , Xu          , Xu          , Xu          , Xu          , Xu          , Qxu         , Qxu         , Qxu         , Qxu         , Uu^Uf       , Ur          , Ur          , Xu          , Xu          , Xu          , Xu          , Xu          , Xu          , Xu          , Xu          , Xu          , Xu          , Xu          , Xu          , Xu          , Xu          , Xu          , Xu          , Xu          , Xu          , Uu          , Uh          , Xu          , Xu          , Xu          , Xu          , Xu
Xu          , Xu          , Xu          , Xu          , Xu          , Chr         , Uu^Vu       , Uu^Uf       , Uu          , Uh          , Uh          , Qxu         , Xu          , Xu          , Xu          , Xu          , Xu          , Xu          , Xu          , Xu          , Xu          , Qxu         , Qxu         , Xu          , Uu          , Uu          , Ur          , Xu          , Xu          , Xu          , Xu          , Xu          , Xu          , Xu          , Xu          , Xu          , Xu          , Xu          , Xu          , Xu          , Xu          , Xu          , Xu          , Xu          , Xu          , Ur          , Uh          , Xu          , Xu          , Xu          , Xu          , Xu
Xu          , Xu          , Xu          , Xu          , Uh          , Xu          , Uh          , Uu          , Uu          , Uh          , Qxu         , Qxu         , Qxu         , Xu          , Uh          , Uu          , Uu^Uf       , Xu          , Xu          , Xu          , Xu          , Qxu         , Qxu         , Xu          , Uu^Uf       , Uh          , Ur          , Uu^Uf       , Uu^Uf       , Xu          , Xu          , Xu          , Xu          , Xu          , Xu          , Xu          , Xu          , Xu          , Xu          , Xu          , Xu          , Xu          , Ur          , Xu          , Ur          , Ur          , Uu          , Xu          , Uu          , Xu          , Xu          , Xu
Uu          , Xu          , Uh          , Uu          , Ur          , Uu          , Uu          , Uu          , Xu          , Xu          , Qxu         , Qxu         , Qxu         , Qxu         , Uu^Uf       , Uu          , Uh          , Uh          , Xu          , Xu          , Qxu         , Qxu         , Uu          , Qxu         , Qxu^Bs/     , Ur          , Uh          , Uh          , Uu          , Xu          , Xu          , Xu          , Xu          , Xu          , Xu          , Xu          , Xu          , Xu          , Xu          , Xu          , egDC        , Ur          , Uh          , Uu          , Uh          , Uu^Uf       , Xu          , Uh          , Xu          , Uh          , Xu          , Xu
Uu          , Ur          , Uu          , Ur          , Xu          , Uu          , Uu          , Uh          , Xu          , Xu          , Qxu         , Qxu         , Qxu         , Qxu         , Qxu         , Uu^Uf       , Uu          , Uu          , Xu          , Xu          , Uh          , Uu^Uf       , Ur          , Uu          , Qxu         , Qxu         , Qxu         , Qxu         , Xu          , Xu          , Xu          , Xu          , Xu          , Xu          , Xu          , Xu          , Xu          , Xu          , Xu          , Ur          , Ur          , Ur          , Xu          , Xu          , Xu          , Xu          , Xu          , Xu          , Xu          , Uu          , Uu^Vu       , Xu
Xu          , Uh          , Xu          , Xu          , Xu          , Uu          , Uh          , Uu          , Uh          , Xu          , Qxu         , Qxu         , Qxu         , Qxu         , Qxu         , Xu          , Uu^Uf       , Uu          , Uu          , Uh          , Uh          , Ur          , Uh          , Uh          , Qxu         , Qxu         , Qxu         , Qxu         , Xu          , Xu          , Xu          , Xu          , Xu          , Xu          , Xu          , Xu          , Xu          , Xu          , Uh          , Ur          , Ur          , Xu          , Xu          , Xu          , Xu          , Xu          , Xu          , Xu          , Xu          , Xu          , Xu          , Xu
Xu          , Xu          , Xu          , Xu          , Xu          , Xu          , Uh          , Uu          , Uu^Uf       , Xu          , Xu          , Qxu         , Qxu         , Qxu         , Uh          , Uu          , Uh          , Uh          , Uu          , Uu          , Uu          , Uu          , Xu          , Xu          , Xu          , Qxu         , Qxu         , Qxu         , Qxu         , Xu          , Xu          , Xu          , Xu          , Xu          , Xu          , Xu          , Uh          , Uu          , Ur          , Ur          , Ur          , Xu          , Ss          , Xu          , Ww          , Xu          , Xu          , Xu          , Xu          , Xu          , Xu          , Xu
Xu          , Xu          , Xu          , Xu          , Xu          , Xu          , Uu^Uf       , Uu          , Uu          , Uu^Uf       , Qxu         , Qxu         , Xu          , Xu          , Uu          , Uu          , Uu^Uf       , Uu          , Xu          , Uu^Uf       , Uu          , Uh          , Qxu         , Xu          , Xu          , Xu          , Qxu         , Qxu         , Qxu         , Xu          , Xu          , Xu          , Urb         , Xu          , Urb         , Xu          , Ur          , Ur          , Ur          , Ur          , Uu^Uf       , Ss^Vm       , Ss          , Ss          , Ww          , Ww          , Ww          , Xu          , Xu          , Xu          , Xu          , Xu
Xu          , Xu          , Xu          , Xu          , Uu^Uf       , Xu          , Uu          , Uh          , Uu          , Uu          , Qxu         , Qxu         , Uu^Uf       , Uu^Uf       , Uu          , Uu^Uf       , Uh          , Uh          , Uu          , Uu^Uf       , Uh          , Uu          , Qxu         , Qxu         , Qxu         , Qxu         , Qxu         , Qxu         , Xu          , Xu          , Xu          , Xu          , Urb         , Urb         , Urb         , Urb         , Ur          , Ur          , Ur          , Uu^Uf       , Uu^Uf       , Uu^Uf       , Ww          , Ww          , Ww          , Ww          , Ww          , Xu          , Xu          , Xu          , Xu          , Xu
Xu          , Xu          , Xu          , Xu          , Uh          , Uu          , Uh          , Uu^Uf       , Uh          , Qxu         , Qxu         , Uu          , Uh          , Uu          , Uh          , Uu          , Uu          , Uh          , Uu          , Uu          , Uu          , Uu          , Uh          , Qxu         , Qxu         , Qxu         , Qxu         , Qxu         , Xu          , Xu          , Xu          , Xu          , Urb         , Urb         , Urb         , Urb         , Uu^Vud      , Ur          , Ur          , Uu^Uf       , Uu^Uf       , Uu^Uf       , Ww          , Ww          , Ww          , Ww          , Ww          , Xu          , Xu          , Xu          , Xu          , Xu
Xu          , Xu          , Xu          , Xu          , Xu          , Uu^Uf       , Uu^Uf       , Uu^Uf       , Uu          , Qxu         , Qxu         , Uu          , Uu          , Uu^Uf       , Xu          , Uu^Uf       , Uu          , Uu          , Qxu         , Uu          , Uu^Uf       , Uu^Uf       , Uh          , Qxu         , Qxu         , Qxu         , Qxu         , Xu          , Xu          , Xu          , Xu          , Xu          , Xu          , Xu          , Xu          , Xu          , egDK        , Uh          , Ur          , Ur          , Ur          , Uu^Vud      , Xu          , Ww          , Ww          , Ww          , Xu          , Xu          , Xu          , Xu          , Xu          , Xu
Xu          , Xu          , Xu          , Xu          , Xu          , Xu          , Uh          , Uu          , Uu          , Uu^Uf       , Uh          , Uh          , Uu          , Uh          , Uh          , Uh          , Uh          , Uu          , Qxu         , Xu          , Uh          , Uu          , Uu^Uf       , Xu          , Xu          , Qxu         , Qxu         , Xu          , Xu          , Xu          , Xu          , Xu          , Xu          , Xu          , Xu          , Xu          , Xu          , egDC        , Xu          , Ur          , Ur          , Uu^Uf       , Xu          , Xu          , Ww          , Ww          , Xu          , Xu          , Xu          , Xu          , Xu          , Xu
Xu          , Xu          , Xu          , Xu          , Xu          , Xu          , Uu^Uf       , Uu          , Uu          , Uu^Uf       , Uh          , Uu          , Xu          , Uu          , Uu^Uf       , Uu^Uf       , Uu          , Uu^Uf       , Uu          , Xu          , Uu          , Uh          , Uh          , Xu          , Xu          , Qxu         , Qxu         , Qxu         , Xu          , Xu          , Xu          , Xu          , Xu          , Xu          , Xu          , Xu          , Xu          , Xu          , egDC        , Ur          , Ur          , Uu^Uf       , Xu          , Ww          , Xu          , Xu          , Xu          , Xu          , Xu          , Xu          , Xu          , Xu
Xu          , Xu          , Xu          , Xu          , Xu          , Xu          , Qxu         , Qxu         , Qxu         , Uu          , Uh          , Xu          , Xu          , Uh          , Uu          , Uh          , Uh          , Uh          , Uu          , Uu^Uf       , Uh          , Uh          , Xu          , Xu          , Xu          , Qxu         , Qxu         , Qxu         , Xu          , Xu          , Xu          , Xu          , Xu          , Xu          , Xu          , Xu          , Xu          , Xu          , Ur          , Ur          , Uu          , Xu          , Xu          , Ww          , Ww          , Xu          , Xu          , Xu          , Wo          , Xu          , Xu          , Xu
Xu          , Xu          , Xu          , Xu          , Qxu         , Qxu         , Qxu         , Xu          , Xu          , Uu^Uf       , Uu          , Uu          , Uu^Uf       , Uu^Uf       , Uh          , Uu          , Uu          , Uh          , Uu          , Uu^Uf       , Uu^Uf       , Xu          , Xu          , Xu          , Xu          , Qxu         , Qxu         , Qxu         , Xu          , Xu          , Xu          , Xu          , Xu          , Xu          , Xu          , Xu          , Ur          , Ur          , Xu          , Xu          , Qxu         , Xu          , Qxu         , Xu          , Xu          , Ww          , Wo          , Wo          , Wo          , Wo          , Xu          , Xu
Xu          , Xu          , Xu          , Qxu         , Qxu         , Qxu         , Qxu         , Xu          , Xu          , Uh          , Uu          , Uh          , Uu          , Uu          , Uu          , Uu          , Uu^Uf       , Uh          , Xu          , Uh          , Xu          , Xu          , Xu          , Xu          , Xu          , Qxu         , Qxu         , Qxu         , Qxu         , Qxu         , Qxu         , Qxu         , Xu          , Xu          , Xu          , Xu          , Uu          , Qxu         , Qxu         , Qxu         , Qxu         , Qxu         , Qxu         , Xu          , Wwr         , Xu          , Ww          , Ww          , Ww          , Xu          , Xu          , Xu
Xu          , Xu          , Xu          , Qxu         , Qxu         , Qxu         , Qxu         , Xu          , Xu          , Uh          , Uu          , Uu^Uf       , Uu^Uf       , Uh          , Uu^Uf       , Uu          , Uu          , Xu          , Xu          , Xu          , Xu          , Xu          , Xu          , Xu          , Xu          , Xu          , Qxu         , Qxu         , Qxu         , Qxu         , Qxu         , Xu          , Xu          , Xu          , Xu          , Ur          , Qxu         , Qxu         , Qxu         , Qxu         , Ur          , Qxu         , Qxu         , Wwr         , Qxu         , Wwr         , Wwr         , Wwr         , Xu          , Xu          , Xu          , Xu
Xu          , Xu          , Xu          , Xu          , Xu          , Qxu         , Xu          , Xu          , Xu          , Xu          , Uu          , Uu          , Uh          , Uh          , Uu^Uf       , Uh          , Uu          , Xu          , Xu          , Xu          , Xu          , Xu          , Xu          , Xu          , Xu          , Xu          , Xu          , Qxu         , Xu          , Qxu         , Qxu         , Qxu         , Qxu         , Xu          , Xu          , Ur          , Qxu^Bs\     , Qxu         , Ur          , Ur          , Xu          , Uu          , Xu          , Qxu         , Qxu         , Wwr         , Uu          , Uu          , Xu          , Xu          , Xu          , Xu
Xu          , Xu          , Xu          , Xu          , Xu          , Xu          , Xu          , Xu          , Xu          , Xu          , Xu          , Uh          , Uu^Uf       , Uu          , Uh          , Uu          , Uu          , Xu          , Xu          , Xu          , Xu          , Xu          , Xu          , Xu          , Xu          , Xu          , Xu          , Xu          , Xu          , Qxu         , Qxu         , Qxu         , Qxu         , Qxu         , Qxu         , Qxu         , Qxu         , Ur          , Xu          , Xu          , Uu^Uf       , Ur          , Ur          , Xu          , Xu          , Xu          , Uu          , Uu^Uf       , Xu          , Xu          , Xu          , Xu
Xu          , Xu          , Xu          , Xu          , Xu          , Xu          , Xu          , Xu          , Xu          , Xu          , Xu          , Xu          , Xu          , Uh          , Xu          , Xu          , Xu          , Xu          , Xu          , Xu          , Xu          , Xu          , Xu          , Xu          , Xu          , Xu          , Xu          , Xu          , Xu          , Xu          , Xu          , Qxu         , Qxu         , Qxu         , Qxu         , Qxu         , Qxu         , Uu^Uf       , Xu          , Xu          , Xu          , Uh          , Xu          , Uu          , Ur          , Uh          , Uu          , Uh          , Xu          , Xu          , Xu          , Xu
Xu          , Xu          , Xu          , Xu          , Xu          , Xu          , Xu          , Xu          , Xu          , Xu          , Xu          , Xu          , Xu          , Xu          , Xu          , Xu          , Xu          , Xu          , Xu          , Xu          , Xu          , Xu          , Xu          , Xu          , Xu          , Xu          , Xu          , Xu          , Xu          , Xu          , Xu          , Xu          , Xu          , Qxu         , Xu          , Qxu         , Qxu         , Qxu         , Qxu         , Xu          , Qxu         , Xu          , Xu          , Xu          , Xu          , Ur          , Uu          , Xu          , Xu          , Xu          , Xu          , Xu
Xu          , Xu          , Xu          , Xu          , Xu          , Xu          , Xu          , Xu          , Xu          , Xu          , Xu          , Xu          , Xu          , Xu          , Xu          , Xu          , Xu          , Xu          , Xu          , Xu          , Xu          , Xu          , Xu          , Xu          , Xu          , Xu          , Xu          , Xu          , Xu          , Xu          , Xu          , Xu          , Xu          , Xu          , Xu          , Qxu         , Xu          , Qxu         , Qxu         , Qxu         , Qxu         , Xu          , Xu          , Xu          , Xu          , Ur          , Ur^Dr       , Uu^Dr       , Xu          , Xu          , Xu          , Xu
Xu          , Xu          , Xu          , Xu          , Xu          , Xu          , Xu          , Xu          , Xu          , Xu          , Xu          , Xu          , Xu          , Xu          , Xu          , Xu          , Xu          , Xu          , Xu          , Xu          , Xu          , Xu          , Xu          , Xu          , Xu          , Xu          , Xu          , Xu          , Xu          , Xu          , Xu          , Xu          , Xu          , Xu          , Xu          , Xu          , Xu          , Xu          , Xu          , Qxu         , Qxu         , Qxu         , Qxu         , Xu          , Xu          , Xu          , Xu          , Uu^Dr       , Xu          , Xu          , Xu          , Xu
Xu          , Xu          , Xu          , Xu          , Xu          , Xu          , Xu          , Xu          , Xu          , Xu          , Xu          , Xu          , Xu          , Xu          , Xu          , Xu          , Xu          , Xu          , Xu          , Xu          , Xu          , Xu          , Xu          , Xu          , Xu          , Xu          , Xu          , Xu          , Xu          , Xu          , Xu          , Xu          , Xu          , Xu          , Xu          , Xu          , Xu          , Xu          , Xu          , Xu          , Xu          , Qxu         , Qxu         , Qxu         , Xu          , Xu          , Xu          , Xu          , Qxu         , Xu          , Qxu         , Qxu
Xu          , Xu          , Xu          , Xu          , Xu          , Xu          , Xu          , Xu          , Xu          , Xu          , Xu          , Xu          , Xu          , Xu          , Xu          , Xu          , Xu          , Xu          , Xu          , Xu          , Xu          , Xu          , Xu          , Xu          , Xu          , Xu          , Xu          , Xu          , Xu          , Xu          , Xu          , Xu          , Xu          , Xu          , Xu          , Xu          , Xu          , Xu          , Xu          , Xu          , Xu          , Qxu         , Qxu         , Qxu         , Xu          , Xu          , Xu          , Xu          , Qxu         , Qxu         , Qxu         , Qxu
