border_size=1
usage=map

Xu          , Xu          , Xu          , Xu          , Xu          , Xu          , Xu          , Xu          , Xu          , Uu          , Uu          , Uu          , Xu          , Xu          , Xu          , Xu          , Xu          , Xu          , Xu          , Xu          , Xu          , Xu          , Xu          , Xu          , Xu          , Xu          , Xu          , Xu          , Xu          , Xu          , Xu          , Xu          , Xu          , Xu          , Xu          , Xu          , Xu          , Xu          , Xu          , Xu
Xu          , Xu          , Xu          , Xu          , Xu          , Xu          , Xu          , Xu          , Uu          , Uu          , Uu^Uf       , Uh          , Xu          , Xu          , Xu          , Xu          , Xu          , Xu          , Xu          , Xu          , Xu          , Xu          , Xu          , Xu          , Xu          , Xu          , Xu          , Xu          , Xu          , Xu          , Xu          , Xu          , Xu          , Xu          , Xu          , Xu          , Xu          , Xu          , Xu          , Xu
Xu          , Xu          , Xu          , Xu          , Xu          , Xu          , Xu          , Xu          , Uh          , Uu          , Uu          , Xu          , Xu          , Xu          , Xu          , Xu          , Xu          , Xu          , Xu          , Xu          , Uh          , Xu          , Xu          , Xu          , Xu          , Xu          , Xu          , Xu          , Uu          , Xu          , Xu          , Xu          , Xu          , Xu          , Ce          , Ce          , Ce          , Xu          , Xu          , Xu
Xu          , Xu          , Xu          , Xu          , Xu          , Xu          , Xu          , Ce          , Ce          , Uh          , Uh          , Uu^Uf       , Uu^Uf       , Xu          , Uu          , Xu          , Uu^Uf       , Xu          , Uu          , Uu          , Uh          , Uh          , Uh          , Xu          , Xu          , Xu          , Uh          , Uu          , Uh          , Uu          , Xu          , Xu          , Xu          , Xu          , Uu          , 5 Ke        , Ce          , Uu          , Xu          , Xu
Xu          , Xu          , Xu          , Xu          , Xu          , Xu          , Xu          , 3 Ke        , Ce          , Uu          , Uu          , Uu          , Uh          , Uh          , Uu          , Uu^Uf       , Uu          , Uu          , Uu          , Uh          , Uu          , Uu          , Uu          , Uh          , Uu          , Xu          , Xu          , Uu          , Uu^Uf       , Uh          , Uh          , Uu          , Uh          , Uh          , Uu^Uf       , Uh          , Uu          , Uh          , Uu          , Xu
Xu          , Xu          , Xu          , Xu          , Xu          , Xu          , Xu          , Ce          , Ce          , Uu          , Uh          , Uu^Uf       , Uh          , Uu          , Uu^Uf       , Uh          , Uu          , Uh          , Uu          , Uh          , Uh          , Uu^Uf       , Uh          , Uu          , Uu          , Uu          , Uu^Uf       , Uu          , Uu          , Uu          , Uu          , Uu          , Uu          , Uh          , Uu          , Uu          , Uh          , Uu^Uf       , Uh          , Xu
Xu          , Xu          , Xu          , Xu          , Xu          , Xu          , Xu          , Uu^Uf       , Uu          , Uu          , Uu          , Uu          , Uu          , Uu          , Xu          , Uu          , Xu          , Uu          , Uh          , Uu^Uf       , Uu          , Uu          , Uu          , Uh          , Uu^Uf       , Uu          , Uh          , Uu          , Uu          , Uu^Uf       , Uh          , Uu^Uf       , Xu          , Uu          , Uu^Uf       , Uu          , Uu          , Uu          , Xu          , Xu
Xu          , Xu          , Xu          , Xu          , Xu          , Xu          , Xu          , Uh          , Uh          , Uh          , Uu          , Uu^Uf       , Uh          , Uh          , Uu^Uf       , Xu          , Xu          , Xu          , Xu          , Xu          , Uh          , Uu^Uf       , Uu^Uf       , Uu          , Uu          , Uh          , Uu          , Uh          , Uh          , Uu          , Uu          , Uu          , Uu          , Xu          , Xu          , Uh          , Uu          , Uu          , Uh          , Xu
Xu          , Xu          , Xu          , Xu          , Xu          , Xu          , Uu^Uf       , Uu          , Uu          , Uh          , Xu          , Xu          , Uu          , Uu          , Uu          , Uu          , Uh          , Xu          , Xu          , Xu          , Xu          , Xu          , Xu          , Uh          , Uu          , Uu          , Uu^Uf       , Uh          , Uu          , Xu          , Xu          , Uh          , Uu          , Xu          , Uu^Uf       , Uh          , Uu          , Uu^Uf       , Uh          , Xu
Xu          , Xu          , Xu          , Xu          , Xu          , Xu          , Uu          , Uu^Uf       , Uh          , Uu          , Xu          , Xu          , Xu          , Uu          , Uu          , Uu          , Uh          , Uh          , Uu^Uf       , Xu          , Xu          , Xu          , Xu          , Uu          , Uu^Uf       , Uh          , Uu          , Uu          , Uu^Uf       , Xu          , Xu          , Uh          , Uu          , Uh          , Uu          , Uu          , Uh          , Uu^Uf       , Xu          , Xu
Xu          , Xu          , Xu          , Xu          , Xu          , Uh          , Uh          , Uu          , Uu          , Uu          , Xu          , Xu          , Xu          , Uh          , Uu          , Uu^Uf       , Uu          , Uu          , Uh          , Xu          , Xu          , Xu          , Xu          , Uh          , Uu^Uf       , Uu          , Uu          , Ur          , Uu          , Uu          , Xu          , Xu          , Uu^Uf       , Uu          , Uu          , Uh          , Uh          , Uu          , Xu          , Xu
Xu          , Xu          , Xu          , Xu          , Xu          , Uh          , Uu          , Uu          , Uu^Uf       , Xu          , Xu          , Xu          , Xu          , Uu^Uf       , Uu^Uf       , Uh          , Uu          , Uu^Uf       , Uu          , Xu          , Xu          , Xu          , Xu          , Uh          , Uh          , Uu          , Uu^Vu       , Uu          , Uu          , Uh          , Uu          , Uu^Uf       , Uh          , Uh          , Uu          , Uu          , Uu^Uf       , Xu          , Xu          , Xu
Xu          , Xu          , Xu          , Xu          , Xu          , Uu          , Uu^Uf       , Uu          , Uu          , Xu          , Xu          , Xu          , Xu          , Uu          , Xu          , Uh          , Uu^Uf       , Uh          , Uu^Vu       , Xu          , Uh          , Xu          , Uu^Uf       , Uh          , Uu^Uf       , Uu^Uf       , Uh          , Uu^Uf       , Uh          , Uu          , Uu          , Uh          , Uu^Uf       , Uu          , Uh          , Uh          , Uu          , Uu          , Xu          , Xu
Xu          , Xu          , Xu          , Xu          , Xu          , Uh          , Uh          , Uh          , Uu^Uf       , Xu          , Xu          , Xu          , Xu          , Xu          , Xu          , Xu          , Xu          , Uu          , Uu          , Uh          , Uu^Uf       , Uh          , Ur          , Uu^Vu       , Ur          , Uu^Uf       , Uu^Uf       , Uu^Uf       , Uu^Uf       , Uu^Vu       , Uh          , Uu          , Uu          , Xu          , Xu          , Uu          , Uu          , Uu^Uf       , Xu          , Xu
Xu          , Xu          , Xu          , Xu          , Xu          , Xu          , Uu          , Uu          , Uu          , Xu          , Xu          , Xu          , Xu          , Xu          , Xu          , Xu          , Uu^Vu       , Uu^Uf       , Uu^Uf       , Uu^Uf       , Ur          , Ur          , Ww          , Ur          , Ww          , Rd          , Rd^Ii       , Uu^Uf       , Uu^Vu       , Uu^Uf       , Uu^Uf       , Uu^Uf       , Xu          , Uu          , Uh          , Uh          , Uu          , Uu^Uf       , Xu          , Xu
Xu          , Xu          , Xu          , Xu          , Xu          , Xu          , Uu^Uf       , Uu          , Uu^Uf       , Uu          , Uh          , Uh          , Uu          , Uu^Uf       , Uu^Uf       , Xu          , Uh          , Uu          , Uu^Vu       , Ur          , Ww          , Ww^Bsb\     , Cud         , Ww          , Ww          , Ww^Ii       , Ww^Ii       , Gg^Ii       , Hh^Ii       , Uh          , Uu^Uf       , Uu^Vu       , Uh          , Uu^Uf       , Uu          , Uu          , Ce          , Uh          , Xu          , Xu
Xu          , Xu          , Xu          , Xu          , Xu          , Uu^Uf       , Uh          , Uu          , Uu          , Uu          , Uu          , Uu          , Uu          , Uh          , Uu          , Uu          , Uu^Vu       , Uu^Uf       , Ur          , Ur          , Ww          , Cud         , 4 Kud       , Cud         , Ww^Vm       , Ww^Ii       , egGf^Ii      , egGf^Ii      , Gg^Ii       , Hh^Fdw      , Uu^Uf       , Uu^Uf       , Uu^Uf       , Uh          , Uu          , Uh          , Ce          , 6 Ke        , Xu          , Xu
Xu          , Xu          , Xu          , Xu          , Xu          , Uu          , Uh          , Uh          , Uu          , Uu^Uf       , Uu^Uf       , Uh          , Uu          , Uu          , Uu^Uf       , Uh          , Uh          , Uu^Uf       , Ur          , Ww          , Ww          , Cud         , Cud         , Cud         , Ww^Ii       , Ww^Ii       , egGf^Ii      , egGf^Ii      , Gg^Ii       , Gs^Fdw      , Gs^Fdw      , Uu^Uf       , Uu^Uf       , Uh          , Uu          , Uh          , Uu^Uf       , Ce          , Xu          , Xu
Xu          , Xu          , Xu          , Xu          , Uu          , Uu          , Uu          , Uu          , Uu          , Uu          , Xu          , Xu          , Xu          , Xu          , Xu          , Uu          , Uu^Uf       , Uu^Vu       , Uh          , Ur          , Ww          , Ww^Vm       , Wwf         , Ww          , Ww          , Ww^Ii       , Uu^Ufi      , Gg^Ii       , Uu^Ufi      , Gs^Vht      , Uu^Uf       , Uu^Uf       , Uu^Vu       , Uh          , Uh          , Uu          , Xu          , Xu          , Xu          , Xu
Xu          , Xu          , Xu          , Xu          , Uu^Uf       , Uu          , Uh          , Uu^Uf       , Uu          , Xu          , Xu          , Xu          , Xu          , Xu          , Xu          , Xu          , Uh          , Uu^Uf       , Uu^Uf       , Ur          , Ww^Bsb\     , Ww          , Ur          , Ww          , Ur          , Uu^Vu       , Uu^Uf       , Uu^Ufi      , Uu^Uf       , Uu^Uf       , Uu^Uf       , Uu^Uf       , Uu          , Uu          , Uu^Uf       , Uu^Uf       , Xu          , Xu          , Xu          , Xu
Xu          , Xu          , Xu          , Xu          , Xu          , Uu          , Uu          , Uh          , Uu          , Xu          , Xu          , Xu          , Uu^Uf       , Uu          , Uu^Uf       , Uu          , Uu          , Uu          , Xu          , Ww          , Uh          , Ur          , Uu          , Ur          , Uh          , Ur          , Ur          , Uh          , Uu          , Uu^Vu       , Uu          , Uh          , Uu^Uf       , Uh          , Uu^Vu       , Uu          , Uh          , Xu          , Xu          , Xu
Xu          , Xu          , Xu          , Xu          , Xu          , Uh          , Uh          , Uu          , Uu          , Uu^Uf       , Uh          , Uh          , Uu          , Uh          , Uu          , Uu          , Uu          , Xu          , Xu          , Ww          , Ww          , Uu^Vu       , Xu          , Xu          , Uu^Vu       , Uu          , Uu^Uf       , Ur          , Uu          , Uh          , Uh          , Uu          , Uu          , Uu          , Uu^Uf       , Uu^Uf       , Xu          , Uu^Uf       , Xu          , Xu
Xu          , Xu          , Xu          , Xu          , Xu          , Xu          , Uu          , Uu          , Uu^Uf       , Uu          , Uu          , Uh          , Uu          , Uu          , Uu          , Uh          , Uh          , Uh          , Uh          , Xu          , Xu          , Ww          , Ww          , Xu          , Uh          , Uu^Uf       , Uu          , Uh          , Uu^Uf       , Ur          , Ur          , Ur          , Ur          , Uh          , Uu^Uf       , Uu          , Uh          , Xu          , Xu          , Xu
Xu          , Xu          , Xu          , Xu          , Xu          , Xu          , Xu          , Uh          , Xu          , Uh          , Xu          , Uu          , Uu^Uf       , Uu          , Uh          , Uu^Uf       , Uu          , Uu          , Uu^Uf       , Uu^Uf       , Uh          , Uu          , Wwf         , Uu          , Uu^Uf       , Uh          , Uu          , Uh          , Uu          , Uu          , Uu^Uf       , Uu^Vu       , Uh          , Ur          , Ur          , Uu          , Uu          , Uh          , Xu          , Xu
Xu          , Xu          , Xu          , Xu          , Xu          , Xu          , Xu          , Xu          , Xu          , Xu          , Xu          , Uu          , Ce          , Uu          , Ce          , Uu          , Uh          , Uh          , Uu          , Uu          , Uu          , Uu^Uf       , Uu          , Wwf         , Uu^Uf       , Uu^Uf       , Uu          , Uu          , Uu^Uf       , Uh          , Uh          , Uu          , Ce          , Uu^Uf       , Uu^Uf       , Ur          , Uh          , Uu^Uf       , Xu          , Xu
Xu          , Xu          , Xu          , Xu          , Xu          , Xu          , Xu          , Xu          , Xu          , Xu          , Xu          , Uu          , Ce          , Ce          , Ce          , Uu          , Uu          , Uu^Uf       , Uu          , Uh          , Uu          , Uu          , Wwf         , Wwf         , Uu          , Uu          , Uu          , Uh          , Uu          , Uh          , Xu          , Xu          , Ce          , 1 Ke        , Ce          , Ur          , Uu          , Uu          , Xu          , Xu
Xu          , Xu          , Xu          , Xu          , Xu          , Xu          , Xu          , Xu          , Xu          , Xu          , Qxu         , Qxu         , Qxu         , 2 Ke        , Ce          , Uh          , Uu          , Uh          , Uu          , Uh          , Uu^Uf       , Uh          , Wwr         , Uu          , Uu          , Uu^Uf       , Xu          , Uh          , Xu          , Xu          , Xu          , Xu          , Xu          , Ce          , Uh          , Uu          , Ur          , Uh          , Uh          , Xu
Xu          , Xu          , Xu          , Xu          , Xu          , Xu          , Xu          , Xu          , Xu          , Qxu         , Qxu         , Qxu         , Qxu         , Qxu         , Qxu         , Qxu         , Qxu         , Qxu         , Qxu         , Xu          , Xu          , Xu          , Wo          , Xu          , Xu          , Uu          , Xu          , Xu          , Xu          , Xu          , Xu          , Xu          , Xu          , Xu          , Uu          , Uu          , Ur          , Uu          , Uu          , Xu
Xu          , Xu          , Xu          , Xu          , Xu          , Xu          , Xu          , Xu          , Xu          , Qxu         , Qxu         , Qxu         , Qxu         , Qxu         , Qxu         , Qxu         , Qxu         , Qxu         , Qxu         , Xu          , Qxu         , Wo          , Xu          , Xu          , Xu          , Xu          , Xu          , Xu          , Qxu         , Qxu         , Qxu         , Qxu         , Qxu         , Xu          , Uh          , Uu          , Uh          , Ur          , Ur          , Uu^Uf
Xu          , Xu          , Xu          , Xu          , Xu          , Xu          , Qxu         , Qxu         , Qxu         , Qxu         , Qxu         , Qxu         , Qxu         , Qxu         , Qxu         , Qxu         , Qxu         , Qxu         , Qxu         , Qxu         , Qxu         , Qxu         , Qxu         , Qxu         , Qxu         , Qxu         , Qxu         , Qxu         , Qxu         , Qxu         , Qxu         , Qxu         , Qxu         , Qxu         , Qxu         , Uu^Uf       , Qxu         , Uu^Uf       , Uh          , Ur
Xu          , Xu          , Xu          , Xu          , Qxu         , Qxu         , Qxu         , Qxu         , Qxu         , Qxu         , Qxu         , Qxu         , Qxu         , Qxu         , Xu          , Qxu         , Xu          , Xu          , Xu          , Qxu         , Xu          , Qxu         , Qxu         , Qxu         , Qxu         , Qxu         , Qxu         , Qxu         , Xu          , Qxu         , Xu          , Xu          , Xu          , Qxu         , Xu          , Qxu         , Qxu         , Xu          , Xu          , Uu
Qxu         , Xu          , Qxu         , Qxu         , Qxu         , Qxu         , Qxu         , Qxu         , Xu          , Xu          , Xu          , Xu          , Xu          , Xu          , Xu          , Xu          , Xu          , Xu          , Xu          , Xu          , Xu          , Xu          , Xu          , Xu          , Xu          , Xu          , Xu          , Xu          , Xu          , Xu          , Xu          , Xu          , Xu          , Xu          , Xu          , Qxu         , Qxu         , Qxu         , Xu          , Xu
Qxu         , Qxu         , Qxu         , Qxu         , Qxu         , Qxu         , Qxu         , Qxu         , Xu          , Xu          , Xu          , Xu          , Xu          , Xu          , Xu          , Xu          , Xu          , Xu          , Xu          , Xu          , Xu          , Xu          , Xu          , Xu          , Xu          , Xu          , Xu          , Xu          , Xu          , Xu          , Xu          , Xu          , Xu          , Xu          , Xu          , Xu          , Qxu         , Qxu         , Qxu         , Xu
Qxu         , Qxu         , Qxu         , Qxu         , Xu          , Qxu         , Xu          , Xu          , Xu          , Xu          , Xu          , Xu          , Xu          , Xu          , Xu          , Xu          , Xu          , Xu          , Xu          , Xu          , Xu          , Xu          , Xu          , Xu          , Xu          , Xu          , Xu          , Xu          , Xu          , Xu          , Xu          , Xu          , Xu          , Xu          , Xu          , Xu          , Xu          , Qxu         , Qxu         , Xu
Xu          , Xu          , Xu          , Xu          , Xu          , Xu          , Xu          , Xu          , Xu          , Xu          , Xu          , Xu          , Xu          , Xu          , Xu          , Xu          , Xu          , Xu          , Xu          , Xu          , Xu          , Xu          , Xu          , Xu          , Xu          , Xu          , Xu          , Xu          , Xu          , Xu          , Xu          , Xu          , Xu          , Xu          , Xu          , Xu          , Xu          , Qxu         , Qxu         , Xu
