border_size=1
usage=map

Xu          , Xu          , Xu          , Xu          , Xu          , Xu          , Xu          , Xu          , Xu
Xu          , Xu          , Xu          , Xu          , Uu          , Xu          , Xu          , Xu          , Xu
Xu          , Xu          , Uu^Uf       , Uu^Emf      , Ce          , Uu^Uf       , Uh^Emf      , Xu          , Xu
Uu          , Uu          , Ce          , Ce          , Ce          , Ce          , Ce          , Uu          , Uu
Uh          , Uh          , Ce          , Ce          , 1 Ke        , Ce          , Ce          , Uh          , Uu^Uf
Xu          , Uu          , Ce          , Ce          , Ce          , Ce          , Ce          , Uu          , Xu
Xu          , Uh          , Uu^Uf       , Ce          , Ce          , Ce          , Uh          , Uu^Emf      , Xu
Xu          , Xu          , Xu          , Uu^Uf       , Uu          , Uu^Uf       , Xu          , Xu          , Xu
Xu          , Xu          , Xu          , Xu          , Xu          , Xu          , Xu          , Xu          , Xu
