border_size=1
usage=map

Xu          , Xu          , Xu          , Uh          , Uu          , Uu          , Re^Br|      , Uu          , Xu          , Xu          , Xu          , Xu          , Xu          , Xu          , Xu          , Xu          , Xu          , Xu          , Ur          , Uu          , Re          , Uu          , Xu          , Xu          , Xu          , Xu          , Xu          , Xu          , Xu          , Xu          , Uh          , Uu          , Uh          , Xu          , Xu          , Xu          , Xu
Xu          , Xu          , Xu          , Uh          , Uu^Uf       , Uh          , Uu^Br|      , Uu          , Xu          , Xu          , Xu          , Xu          , Xu          , Xu          , Xu          , Xu          , Xu          , Xu          , Ur          , Ur          , Ur          , Uh          , Uu^Uf       , Xu          , Xu          , Xu          , Xu          , Xu          , Uh          , Re          , Rd          , Ur          , Uu          , Xu          , Xu          , Xu          , Xu
Xu          , Xu          , Xu          , Xu          , Uh          , Re          , Ur^Br|      , Re          , Uh          , Xu          , Xu          , Xu          , Xu          , Xu          , Xu          , Xu          , Xu          , Xu          , Ur          , Ur          , Rd          , Uu^Uf       , Re          , Xu          , Xu          , Xu          , Re          , Uh          , Ur          , Re          , Uh          , Uu^Uf       , Uh          , Xu          , Xu          , Xu          , Xu
Xu          , Xu          , Xu          , Xu          , Uh          , Uu          , Ur^Br\      , Re          , Uu^Uf       , Uh          , Xu          , Xu          , Xu          , Xu          , Xu          , Xu          , Xu          , Uh          , Uu          , Ur          , Ur          , Re          , Uu^Uf       , Xu          , Xu          , Xu          , Re          , Re          , Ur          , Uu          , Re          , Uu^Uf       , Xu          , Xu          , Xu          , Xu          , Xu
Xu          , Xu          , Xu          , Xu          , Xu          , Re          , Uu^Uf       , Ur^Br|      , Rd          , Uu          , Uu          , Xu          , Xu          , Xu          , Xu          , Xu          , Xu          , Xu          , Uu          , Ur          , Ur          , Uh          , Uu^Uf       , Uh          , Uu          , Uh          , Rd          , Ur          , Uu          , Uu^Uf       , Re          , Uh          , Xu          , Xu          , Xu          , Xu          , Xu
Xu          , Xu          , Xu          , Xu          , Xu          , Uu          , Re          , Uu^Br\      , Ur^Br\      , Re          , Re          , Uu^Uf       , Re          , Xu          , Uh          , Xu          , Xu          , Xu          , Uh          , Rd          , Ur          , Uu          , Re          , Uu^Uf       , Uh          , Rd          , Ur          , Re          , Uh          , Re          , Uu          , Uu^Uf       , Xu          , Xu          , Xu          , Xu          , Xu
Xu          , Xu          , Xu          , Xu          , Xu          , Xu          , Uu          , Re          , Uu^Uf       , Uu^Br\      , Ur^Dr       , Re          , Uu          , Uh          , Uu^Uf       , Uh          , Re          , Re          , Rd          , Ur          , Ur          , Re          , Re          , Uu          , Rd          , Rd          , Ur          , Uu^Uf       , Uu^Uf       , Re          , Uh          , Uh          , Xu          , Xu          , Xu          , Xu          , Xu
Xu          , Xu          , Xu          , Xu          , Xu          , Xu          , Uh          , Uh          , Re          , Rd          , Ur          , Uu^Br\      , Uu^Br|      , Re          , Uu^Uf       , Re          , Uu          , Uh          , Qxu         , Ur          , Qxu         , Ur          , Rd          , Ur          , Re          , Re          , Uh          , Rd          , Re          , Re          , Xu          , Xu          , Xu          , Xu          , Xu          , Xu          , Xu
Xu          , Xu          , Xu          , Xu          , Xu          , Xu          , Uu^Uf       , Uh          , Uh          , Re          , Uu^Uf       , Ur          , Ur^Br\      , Uh          , Uu          , Uu          , Uh          , Re          , Qxu         , Qxu^Bs|     , Qxu^Bs/     , Ur          , Qxu         , Uu          , Uu^Uf       , Uh          , Rd          , Uu          , Uh          , Xu          , Xu          , Xu          , Xu          , Xu          , Xu          , Xu          , Xu
Xu          , Xu          , Xu          , Xu          , Uh          , Re          , Uu^Uf       , Uu^Uf       , Re          , Re          , Uh          , Uu^Vu       , Ur          , Ur^Br\      , Ur^Br\      , Re          , Uu^Vud      , Chr         , Ur          , Ur          , Ur          , Qxu         , Qxu         , Qxu         , Qxu         , Qxu         , Uh          , Uu          , Uu^Uf       , Re          , Re          , Xu          , Xu          , Xu          , Xu          , Xu          , Xu
Re          , Uh          , Re          , Uu^Uf       , Re          , Uu          , Re^Br\      , Uu          , Uh          , Uu          , Uu^Br\      , Uh          , Ur^Br/      , Ur^Br/      , Ur          , Ur^Br\      , Ur^Br/      , Ur^Br\      , Ur^Br\      , Ur          , Uu^Uf       , Uh          , Uu^Vu       , Uh          , Qxu         , Qxu         , Uu          , Rd          , Uh          , Uu^Uf       , Uh          , Uh          , Uh          , Xu          , Xu          , Xu          , Xu
Ur          , Uu          , Ur          , Ur          , Ur^Br/      , Ur^Br/      , Ur          , Uu^Br\      , Ur^Br/      , Ur^Br/      , Ur          , Ur^Br/      , Ur          , Ur          , Rd          , Ur          , Ur          , Ur          , Ur          , Uu^Br\      , Uu^Br|      , Re          , Re          , Re          , Uh          , Uh          , Re          , Rd          , Rd          , Uu^Uf       , Re          , Re          , Uu^Uf       , Uu^Uf       , Uh          , Re          , Re
Ur^Br\      , Ur          , Ur^Br/      , Ur^Br/      , Rd          , Ur          , Ur          , Ur          , Ur          , Ur          , Ch          , Ur          , Ur          , Rd          , Uu^Uf       , Re          , Re          , Ur          , Ur          , Ur          , Ur^Br\      , Uh          , Uh          , Re          , Uu          , Uu^Uf       , Uh          , Re          , Uu^Vu       , Rd          , Uu          , Uu          , Rd          , Re          , Ur          , Uu          , Uu
Uu          , Ur^Br/      , Uu^Uf       , Re          , Uu          , Uh          , Uu^Uf       , Re          , Re          , Re          , Uu^Vud      , Ur          , Ur          , Uh          , Uu          , Uu^Vu       , Xu          , Xu          , Ch          , Ur          , Ur          , Ur^Br\      , Ur^Br\      , Ur          , Ur          , Ur          , Rd          , Ur          , Ur          , Ur          , Uu          , Ur          , Uh          , Uu          , Uh          , Uu^Uf       , Uu
Xu          , Uh          , Xu          , Uh          , Xu          , Uh          , Xu          , Uh          , Uu^Uf       , Uh          , Re          , Uh          , Ur          , Uh          , Qxu         , Qxu         , Chr         , Ch          , 1 Kh        , Chr         , Chr         , Ur          , Ur          , Ur^Br\      , Chr         , Uu          , Uu          , Uh          , Re          , Uu          , Re          , Uh          , Xu          , Uu^Uf       , Xu          , Xu          , Xu
Xu          , Xu          , Xu          , Xu          , Xu          , Xu          , Xu          , Xu          , Xu          , Re          , Re          , Uu^Uf       , Re          , Ur          , Ur          , Qxu         , Chr         , Ch          , Chr         , Chr         , Ch          , Uu^Vud      , Ur          , Uu^Br|      , Uu^Uf       , Uh          , Uu          , Re          , Uu^Uf       , Re          , Xu          , Xu          , Xu          , Xu          , Xu          , Xu          , Xu
Xu          , Xu          , Xu          , Xu          , Xu          , Xu          , Xu          , Xu          , Xu          , Uh          , Uu          , Re          , Uu          , Rd          , Rd          , Ur          , Chr         , Chr         , Chr         , Ch          , Chr         , Ur          , Ur^Br/      , Ur^Br/      , Uu          , Re          , Re          , Uu          , Uh          , Uu          , Xu          , Xu          , Xu          , Xu          , Xu          , Xu          , Xu
Xu          , Xu          , Xu          , Xu          , Xu          , Xu          , Xu          , Xu          , Re          , Re          , Re          , Re          , Uh          , Rd          , Uh          , Ur          , Ur          , Uu^Vud      , Ur^Br\      , Ch          , Ur^Br|      , Ur^Br/      , Ur          , Ch          , Ur          , Uu          , Re          , Uh          , Uu          , Uu^Uf       , Uh          , Xu          , Uu^Uf       , Xu          , Xu          , Xu          , Uu
Xu          , Xu          , Xu          , Xu          , Xu          , Xu          , Xu          , Xu          , Re          , Re          , Re          , Uu^Uf       , Uu^Vu       , Rd          , Ur          , Ur          , Ur          , Ur          , Ur          , Ur^Br\      , Ur^Br|      , Ur          , Ur          , Ur          , Ur          , Ur          , Ur          , Uu^Uf       , Uu          , Re          , Rd          , Re          , Uu          , Uu^Uf       , Rd          , Uu          , Uu
Xu          , Xu          , Xu          , Xu          , Xu          , Xu          , Xu          , Xu          , Re          , Uu          , Uh          , Uu          , Rd          , Ur          , Chr         , Ur          , Uu^Uf       , Ur          , Ur          , Ur          , Uu^Br/      , Uu^Vu       , Uh          , Ur          , Ur          , Ur          , Ur          , Ur          , Ur          , Ur          , Ur          , Ur          , Ur          , Ur          , Ur          , Ur          , Ur
Xu          , Xu          , Xu          , Xu          , Xu          , Xu          , Re          , Uu          , Uu          , Re          , Ur          , Uu          , Rd          , Ur          , Uh          , Re          , Uu          , Ur          , Ur^Br/      , Uu^Br/      , Uh          , Uu^Uf       , Re          , Uh          , Uu          , Rd          , Ur          , Ur          , Ur          , Ur          , Uu^Uf       , Ur          , Rd          , Ur          , Re          , Re          , Uu
Xu          , Xu          , Xu          , Xu          , Uh          , Uh          , Uu          , Uu          , Ur          , Rd          , Uu^Uf       , Rd          , Uu          , Uh          , Re          , Uh          , Re          , Ur^Br/      , Ur          , Ur          , Uu          , Re          , Re          , Uu          , Uu^Uf       , Ur          , Ur          , Rd          , Uh          , Uu^Uf       , Uh          , Re          , Uh          , Re          , Uu^Uf       , Uh          , Uu
Xu          , Xu          , Xu          , Xu          , Uu^Uf       , Uh          , Rd          , Ur          , Re          , Uu          , Uu^Uf       , Uh          , Xu          , Uu          , Re          , Uu^Uf       , Uu^Uf       , Ur^Br|      , Ur          , Ur          , Uu          , Uu          , Xu          , Xu          , Uh          , Uu^Uf       , Rd          , Ur          , Uu          , Re          , Re          , Re          , Xu          , Xu          , Xu          , Xu          , Xu
Xu          , Xu          , Uu^Uf       , Uu^Uf       , Re          , Uu          , Uu          , Re          , Re          , Re          , Xu          , Xu          , Xu          , Xu          , Xu          , Uh          , Uu          , Uu^Br|      , Ur          , Ur          , Uu^Uf       , Re          , Xu          , Xu          , Xu          , Re          , Re          , Ur          , Rd          , Re          , Uh          , Xu          , Xu          , Xu          , Xu          , Xu          , Xu
Xu          , Xu          , Re          , Re          , Rd          , Ur          , Uu^Uf       , Uh          , Uu^Uf       , Uu^Uf       , Xu          , Xu          , Xu          , Xu          , Xu          , Xu          , Re          , Uu^Br|      , Ur          , Ur          , Uh          , Xu          , Xu          , Xu          , Xu          , Uu          , Uu          , Rd          , Rd          , Uu          , Rd          , Xu          , Xu          , Xu          , Xu          , Xu          , Xu
Re          , Uu^Uf       , Rd          , Rd          , Uh          , Uu          , Re          , Re          , Xu          , Xu          , Xu          , Xu          , Xu          , Xu          , Xu          , Xu          , Re          , Uu^Br|      , Ur^Br\      , Ur          , Uu          , Uh          , Xu          , Xu          , Xu          , Uu^Uf       , Re          , Uu^Uf       , Uu          , Ur          , Ur          , Uu          , Uh          , Xu          , Uh          , Xu          , Xu
Uu          , Rd          , Re          , Xu          , Xu          , Xu          , Xu          , Xu          , Xu          , Xu          , Xu          , Xu          , Xu          , Xu          , Xu          , Xu          , Xu          , Uu          , Ur          , Ur^Br\      , Ur^Br\      , Uu^Uf       , Uu^Uf       , Xu          , Xu          , Xu          , Uu          , Re          , Uu          , Uh          , Re          , Rd          , Uu          , Uu^Uf       , Uh          , Xu          , Xu
Uh          , Uu          , Xu          , Xu          , Xu          , Xu          , Xu          , Xu          , Xu          , Xu          , Xu          , Xu          , Xu          , Xu          , Xu          , Xu          , Xu          , Uu^Uf       , Uh          , Ur          , Ur^Br|      , Re          , Uh          , Xu          , Xu          , Xu          , Xu          , Re          , Uu^Uf       , Uu^Uf       , Uh          , Uu          , Ur          , Re          , Re          , Uu          , Re
Xu          , Xu          , Xu          , Xu          , Xu          , Xu          , Xu          , Xu          , Xu          , Xu          , Xu          , Xu          , Xu          , Xu          , Xu          , Xu          , Uh          , Uu          , Ur          , Ur          , Ur^Br|      , Re          , Uu^Uf       , Xu          , Xu          , Xu          , Xu          , Xu          , Xu          , Xu          , Xu          , Re          , Uu          , Uu          , Uu          , Uh          , Uu^Uf
Xu          , Xu          , Xu          , Xu          , Xu          , Xu          , Xu          , Xu          , Xu          , Xu          , Xu          , Xu          , Xu          , Xu          , Xu          , Xu          , Xu          , Uu          , Ur          , Ur          , Uu^Br|      , Uu          , Xu          , Xu          , Xu          , Xu          , Xu          , Xu          , Xu          , Xu          , Xu          , Xu          , Xu          , Uh          , Uu^Uf       , Uu          , Uu
