border_size=1
usage=map

Gs^Fp       , Gs^Fds      , Gs^Fms      , Gs^Fp       , Gs^Fms      , Gs^Fds      , Gs^Fmw      , Gs^Fds      , Gs^Fds      , Gs^Fp       , Gs^Fmw      , Gs^Fp       , Gs^Fds      , Gs^Fp       , Gs^Fds      , Gs^Fp       , Ww          , Gs^Fds      , Gs^Fms      , Rd          , Gs^Fp       , Gs^Fds
Gs^Fmw      , Gs^Fms      , Gs^Fms      , Gs^Fds      , Gs^Fmw      , Gs^Fms      , Gs^Fmw      , Gs^Fds      , Gs^Fms      , Gs^Fms      , Gg^Ve       , Gs^Fms      , Gs^Fms      , Gs^Fms      , Gs^Fms      , Gs^Fms      , Gs^Fms      , Ww          , Gs^Fmw      , 1 Rd        , Gs^Fms      , Gs^Fms
Gs^Fms      , Gs^Fms      , Gs^Fp       , Gs^Fms      , Gg^Ve       , Gs^Fms      , Gs^Fds      , Gs^Fms      , Gs^Fds      , Gs^Fms      , Gs^Fds      , Gg^Efm         , Gs^Fms      , Gs^Fms      , Rd          , Rd          , Rd          , Ww          , Rd          , Rd          , Gg^Efm         , Gs^Fms
Gs^Fp       , Gs^Fms      , Gs^Fms      , Gs^Fds      , Gs^Fp       , Gs^Fms      , Gs^Fms      , Gs^Fms      , Gs^Fms      , Gs^Fms      , Cv          , Gs^Fds      , Gg          , Gg^Efm         , Rd          , Gs^Fms      , Ww          , Wwf         , Gs^Fms      , Gg          , Gs^Fms      , Gs^Fds
Gs^Fmw      , Gs^Fms      , Gs^Fmw      , Gs^Fp       , Gs^Fms      , Gs^Fms      , Gs^Fds      , Gs^Fms      , Gg^Ve       , Cv          , Kv          , Cv          , Rd          , Rd          , Gg          , Gs^Fms      , Ww          , Gs^Fms      , Gs^Fms      , Gs^Fms      , Gg^Efm         , Gs^Fms
Gs^Fds      , Gs^Fds      , Gs^Fds      , Gg^Ve       , Gs^Fds      , Gg^Efm         , Gs^Fds      , Cv          , Kv          , Cv          , Cv          , Cv          , 2 Kv        , Cv          , Ww          , Ww          , Gg^Efm         , Gs^Fms      , Gg^Ve       , Gs^Fp       , Gs^Fms      , Gs^Fp
Gs^Fp       , Gs^Fmw      , Gs^Fds      , Gs^Fms      , Rd          , Rd          , Rd          , Rd          , Cv          , Cv          , Gg^Fet      , Cv          , Cv          , Ww          , Ww          , Gg^Efm         , Gg^Ve       , Gs^Fms      , Gs^Fmw      , Gs^Fds      , Gs^Fms      , Gs^Fms
Gs^Fds      , Gs^Fms      , Rd          , Rd          , Gs^Fms      , Gs^Fp       , Gg^Ve       , Gg^Efm         , Kv          , Cv          , Cv          , Cv          , Kv          , Gs^Fms      , Gs^Fms      , Ww          , Gs^Fmw      , Gg^Efm         , Gs^Fms      , Gs^Fms      , Gs^Fmw      , Gs^Fmw
Gs^Fds      , Rd          , Gg          , Gs^Fms      , Gs^Fms      , Gs^Fms      , Ww          , Cv          , Ww^Vm       , Cv          , Kv          , Cv          , Rd          , Cv          , Ww          , Ww          , Gs^Fms      , Gs^Fms      , Gs^Fms      , Gs^Fms      , Gs^Fds      , Gs^Fms
Rd          , Rd          , Gs^Fms      , Gs^Fms      , Gs^Fms      , Ww          , Wo          , Ww          , Ww          , Cv          , Cv          , Cv          , Gs^Fms      , Ww^Bw\      , Rd          , Gs^Fmw      , Gs^Fmw      , Gs^Fms      , Gs^Fds      , Gg^Ve       , Gs^Fms      , Gs^Fmw
Gg          , Gs^Fmw      , Gg^Ve       , Gs^Fms      , Gs^Fmw      , Ww          , Wo          , Wo          , Wo          , Ww          , Ww          , Ww          , Ww          , Ww          , Gs^Fms      , Rd          , Gs^Fds      , Gs^Fmw      , Gs^Fp       , Gs^Fmw      , Gs^Fmw      , Gs^Fds
Gs^Fms      , Gs^Fds      , Gg^Efm         , Gs^Fmw      , Gs^Fds      , Ww          , Ww          , Wo          , Ww          , Ww          , Gs^Fds      , Gs^Fms      , Gs^Fds      , Gs^Fms      , Gs^Fmw      , Rd          , Rd          , Gg          , Rd          , Gs^Fds      , Gs^Fms      , Gs^Fms
Gs^Fmw      , Gs^Fp       , Gs^Fms      , Gs^Fms      , Ww          , Ww          , Gs^Fms      , Ww          , Gs^Fms      , Gs^Fp       , Gg^Efm         , Gs^Fms      , Gs^Fms      , Gs^Fms      , Gs^Fms      , Gg^Ve       , Gs^Fds      , Rd          , Gg^Efm         , Rd          , Gs^Fds      , Gs^Fmw
Gs^Fds      , Gs^Fms      , Gs^Fds      , Ww          , Gs^Fds      , Gs^Fmw      , Gs^Fds      , Gs^Fms      , Gs^Fms      , Gs^Fms      , Gg^Ve       , Gs^Fms      , Gs^Fms      , Gs^Fds      , Gs^Fms      , Gs^Fmw      , Gs^Fms      , Gs^Fms      , Gs^Fms      , Rd          , Rd          , Gs^Fp
Gs^Fp       , Gs^Fms      , Gs^Fp       , Ww          , Gs^Fmw      , Gs^Fms      , Gs^Fmw      , Gs^Fds      , Gs^Fms      , Gs^Fp       , Gs^Fms      , Gs^Fmw      , Gs^Fms      , Gg^Efm         , Gs^Fms      , Gs^Fds      , Gs^Fmw      , Gs^Fms      , Gs^Fms      , Gs^Fp       , Gs^Fmw      , Rd
Gs^Fds      , Gs^Fmw      , Ww          , Ww          , Gs^Fds      , Gs^Fms      , Gs^Fds      , Gs^Fms      , Gs^Fds      , Gs^Fms      , Gs^Fmw      , Gs^Fms      , Gs^Fds      , Gs^Fms      , Gs^Fmw      , Gs^Fms      , Gs^Fds      , Gs^Fmw      , Gs^Fds      , Gs^Fms      , Gs^Fds      , Gs^Fds
