border_size=1
usage=map

Gg          , Gg          , Gg          , Gg          , Gg          , Gg          , Gs^Fp       , Gs^Fms      , Gs^Fms      , Gs^Fms      , Gs^Fds      , Gs^Fms      , Gs^Fp       , Gg          , Ww          , Gs^Fp       , Gs^Fds      , Gs^Fp       , Gs^Fp       , Gs^Fms
Gg          , Gg          , 2 Ke        , Ce          , Gg          , Gg          , Gs^Fmw      , Gs^Fds      , Gs^Fmw      , Gg^Efm         , Gs^Fmw      , Gs^Fmw      , Gs^Fds      , Gs^Fmw      , Gs^Fp       , Ww          , Gs^Fds      , Gs^Fds      , Gs^Fds      , Gs^Fds
Rd          , Ce          , Ce          , Ce          , Gg          , Gg          , Gs^Fds      , Gg          , Gs^Fms      , Gg^Vh       , Gs^Fmw      , Gs^Fms      , Gs^Fmw      , Gs^Fms      , Ww          , Ww          , Gs^Fmw      , Gs^Fms      , Rd          , Rd
Gg          , Gg          , Gg          , Gg          , Gs^Fmw      , Gs^Fp       , Gs^Fms      , Gs^Fds      , Gs^Fms      , Gs^Fms      , Gs^Fms      , Gs^Fds      , Gs^Fms      , Gs^Fds      , Gs^Fmw      , Ww          , Ww          , Gs^Fms      , Gg          , Rd
Gg          , Gs^Vht      , Gs^Fms      , Gg          , Gs          , Gs^Fp       , Gs^Fds      , Gs^Fds      , Gs^Fms      , Gs^Fds      , Gs^Fmw      , Gs^Fms      , Gs^Fds      , Gs^Fds      , Gs^Fms      , Ww^Vm       , Ww          , Ww          , Rd          , Rd
Gg          , Gs^Fms      , Gs^Fms      , Gs^Fms      , Gs^Fds      , Gs^Fms      , Gs^Fms      , Gs^Fms      , Gs^Fp       , Gs^Fds      , Gs^Fms      , Gs^Fp       , Gs          , Gs^Fms      , Ww          , Ww          , Ww          , Ww          , Rd          , Gs^Fp
Gs^Fp       , Gs^Fms      , Gs^Fds      , Gg^Efm         , Gs^Fmw      , Gs^Fmw      , Gs^Fp       , Gs^Fms      , Gs^Fds      , Gg^Ve       , Gs^Fms      , Gs^Fms      , Gs^Fms      , Wwf         , Gs^Fms      , Ww          , Gs^Fms      , Rd          , Gg^Efm         , Gs^Fp
Gs^Fds      , Gs^Fms      , Gg^Vc       , Gs^Fms      , Gs^Fms      , Gs^Fds      , Gs^Fds      , Gs^Fms      , Gs^Fds      , Gs^Fds      , Gs^Fms      , Gs^Fp       , Gs^Fp       , Ww          , Gg^Ve       , Rd          , Rd          , Rd          , Gs^Fms      , Gs^Fds
Gg          , Gs^Fms      , Gs^Fmw      , Gs^Fds      , Gs^Fms      , Gs^Fms      , Gs^Fmw      , Gs^Fms      , Gs^Fms      , Gs^Fds      , Gs^Fmw      , Gg^Efm         , Gs^Fms      , Ww          , Ww          , Gs^Fms      , Rd          , Gs^Fmw      , Gs^Fmw      , Gs^Fds
Gs^Fds      , Gs^Fp       , Gs^Fds      , Gs^Fms      , Gs^Fds      , Gs^Fds      , Gs^Fms      , Gs^Fmw      , Gs^Fds      , Gs^Fp       , Gs^Fds      , Gs^Fms      , Gs^Fds      , Gs^Fp       , Ww          , Gs^Fms      , Gg          , Rd          , Gs^Fms      , Gs^Fms
Gs^Fp       , Gs^Fms      , Gs^Fms      , Gs^Fms      , Gg^Ve       , Gs^Fms      , Gs^Fmw      , Gs^Fds      , Gs^Fms      , Gg^Fet      , Gs^Fmw      , Gs^Fp       , Gg^Ve       , Gs^Fms      , Ww          , Ww          , Gs^Fp       , Rd          , Gs^Fds      , Gs^Fp
Gs^Fp       , Gs^Fds      , Gs^Fp       , Gs^Fds      , Gs^Fp       , Gs^Fds      , Gs^Fds      , Gs^Fmw      , Gs^Fds      , Gs^Fms      , Gs^Fms      , Gs^Fds      , Gs^Fms      , Gs^Fp       , Ww          , Gs^Fms      , 1 Gs^Fds    , Rd          , Rd          , Gs^Fp
Ww          , Ww          , Ww          , Ww          , Ww          , Gs^Fp       , Gs^Fds      , Gs^Fms      , Gs^Fds      , Gs^Fp       , Gs^Fds      , Gs^Fms      , Gs^Fmw      , Gs^Fms      , Gs^Fp       , Ww          , Ww          , Gs^Fp       , Rd          , Gs^Fp
Wo          , Wo          , Wo          , Wo          , Wo          , Ww          , Ww          , Gs^Fp       , Ww          , Gs^Fp       , Gs^Fds      , Gs^Fp       , Gs^Fds      , Gs^Fms      , Gg^Efm         , Ww^Vm       , Rd          , Ww^Bw/      , Gs^Fms      , Gs^Fp
Wo          , Wo          , Wo          , Wo          , Wo          , Wo          , Wo          , Ww          , Ww          , Ww          , Ww          , Gs^Fp       , Rd          , Gg^Ve       , Rd          , Rd          , Cv          , Ww          , Gs^Fp       , Gs^Fds
Ww          , Ww          , Ww          , Wo          , Ww          , Wo          , Ww          , Ww          , Gs^Fds      , Ww          , Ww          , Wwf         , Ww          , Rd          , Cv          , Cv          , 3 Kv        , Ww          , Gs^Fmw      , Gs^Fms
Gs^Fp       , Gs^Fms      , Gg          , Ww          , Gs^Fds      , Ww          , Ww          , Gs^Fms      , Rd          , Rd          , Ww          , Ww          , Wo          , Ww          , Ww          , Cv          , Ww          , Ww          , Gg^Ve       , Gs^Fp
Gs^Fp       , Gs^Fmw      , Gg^Ve       , Gs^Fds      , Gs^Fp       , Ww          , Ww          , Wwf         , Ww          , Ww          , Wo          , Wo          , Wo          , Wo          , Wo          , Ww          , Ww          , Gs^Fds      , Gs^Fds      , Gs^Fms
Gg          , Gg          , Gs^Fp       , Gs^Fms      , Rd          , Rd          , Rd          , Ww          , Ww          , Ww          , Ww          , Ww          , Ww          , Wo          , Wo          , Wo          , Wo          , Ww          , Gs^Fp       , Gs^Fms
Gg          , Gg          , Gs^Fds      , Gg          , Rd          , Gs^Fp       , Gg          , Gs^Fds      , Gs^Fms      , Gg^Efm         , Gg          , Gs^Fds      , Gs^Fp       , Ww          , Wo          , Wo          , Wo          , Ww          , Ww          , Gs^Fp
