border_size=1
usage=map

Gs^Fms      , Gs^Fms      , Gs^Fms      , Gg          , Gg          , Gs^Fms      , Gs^Fms      , Gs^Fms      , Gs^Fms      , Gs^Fms      , Gs^Fms      , Gs^Fp       , Gs^Fms      , Gs^Fms      , Gs^Fms      , Gg          , Ss          , Ss          , Ww          , Wo          , Ww          , Ss          , Ss          , Gs^Fms      , Gs^Fds      , Gs^Fp       , Gg^Efm         , Gs^Fms      , Gs^Fp       , Gs^Fms      , Gs^Fds      , Gs^Fms      , Gs^Fp       , Gs^Fms      , Gg          , Gg          , Rd          , Gg          , Gg          , Gg          , Gg          , Gg
Gs^Fms      , Gs^Fp       , Gs^Fds      , Gs^Fms      , Gs^Fp       , Gs^Fds      , Gs^Fms      , Gg^Ve       , Gs^Fms      , Gs^Fmw      , Gs^Fp       , Gs^Fms      , Gs^Fds      , Gs^Fp       , Gs^Fmw      , Gs^Fds      , Ss          , Ww          , Wo          , Wo          , Ww          , Ss          , Ss          , Gs^Fms      , Gg          , Gs^Fms      , Gs^Fms      , Gs^Fmw      , Gs^Fms      , Gs^Fms      , Gg^Ve       , Gs^Fms      , Gg          , Gs^Fp       , Gg          , Rd          , Gg          , Gg          , Gs^Fms      , Gg          , Gs^Fds      , Gs^Fp
Gs^Fms      , Gs^Fms      , Gs^Fms      , Gs^Fms      , Gs^Fms      , Gs^Fds      , Gs^Fmw      , Gg          , Gs^Fms      , Gs^Fds      , Ss          , Gs^Fms      , Ss          , Gs^Fds      , Ss          , Ss          , Ww          , Ww          , Wo          , Ww          , Ww          , Ss          , Ss          , Ss          , Ss^Vm       , Gs^Fms      , Ss          , Ss          , Ss          , Gs^Fms      , Gg          , Gs^Fms      , Rd          , Gg          , Rd          , Rd          , Gs^Fms      , Gs^Fds      , Gs^Fmw      , Gg          , Gs^Fms      , Gs^Fms
Gs^Fms      , Gs^Fms      , Gg^Efm         , Gs^Fmw      , Gs^Fms      , Gs^Fds      , Gs^Fms      , Gs^Fms      , Gs^Fms      , Ss          , Ss          , Ss          , Ss^Vm       , Ss          , Ss          , Ss          , Ss          , Ww          , Ww          , Wo          , Ww          , Ww^Vm       , Ss          , Ss          , Ww          , Ss          , Wwf         , Wwf         , Wwf         , Wwf         , Wwf^Bw/     , Rd          , Ch          , Rd          , Gg          , Gg^Ve       , Gs^Fms      , Gg^Efm         , Gs^Fms      , Gg          , Gg          , Gg
Gs^Fp       , Gs^Fms      , Ss          , Gg          , Ss          , Gs^Fms      , 3 Kh        , Ch          , Ss          , Ss          , Ss          , Ss          , Ss          , Ss          , Ww          , Ww          , Ww          , Ss          , Ww          , Wo          , Wo          , Ww          , Ww          , Ss          , Ss          , Ss          , Ww          , Wwf         , Wwf         , Wwf^Bw/     , Wwf         , Chw         , Ch          , 2 Kh        , Ch          , Gg          , Ss          , Gg          , Gg          , Gs^Fms      , Gg          , Gs^Fms
Ss          , Gs^Fmw      , Gs^Fms      , Ss          , Ww          , Ch          , Ch          , Ch          , Ww          , Ss          , Ww          , Ss          , Ww          , Ww          , Ss          , Ww          , Ss          , Ss          , Ss          , Ww          , Wo          , Ww          , Ww          , Ww          , Ww          , Ss          , Ww          , Wwf         , Wwf         , Wwf         , Wwf         , Wwf         , Wwf         , Ch          , Chs         , Ss          , Ss          , Gg          , Ss          , Gg          , Ss          , Gg
Ss          , Ss^Vm       , Ss          , Ss          , Ss          , Ss          , Ww          , Ww          , Ww          , Ww          , Ww          , Ss          , Ss          , Ss          , Ss          , Ss          , Ss          , Ss          , Ww          , Ww          , Wo          , Wo          , Ww          , Ss          , Ww          , Ww          , Ww          , Ww          , Ww          , Wwf         , Wwr         , Wwf         , Ss          , Ss          , Ss          , Ss          , Ww          , Ss          , Ss          , Ss          , Ss          , Gg
Ww          , Ss          , Ww          , Ww          , Ww          , Ss          , Ww          , Ww          , Ww          , Ww          , Ss          , Ww          , Ss          , Ss          , Ds          , Wwf         , Wwf         , Ww          , Ss          , Ww          , Ww          , Wo          , Wo          , Ww          , Ww          , Ww          , Ww          , Ww^Vm       , Ww          , Ww          , Ww          , Wwr         , Wwr         , Ss          , Ss          , Ss          , Ss          , Ss          , Ss          , Ss          , Ss          , Ss
Ww          , Ww          , Ww          , Ww          , Ww          , Ww          , Ww          , Ww^Vm       , Ww          , Ww          , Ww          , Ss          , Ss          , Ds          , Hd          , Ds          , Wwr         , Wwr         , Ww          , Ww          , Ww          , Wo          , Wo          , Wo          , Wo          , Wo          , Wo          , Ww          , Ww          , Ww          , Ww          , Ww          , Ww          , Ww          , Ww          , Ww          , Ww^Vm       , Ww          , Ss          , Ss          , Ww          , Ww
Ww          , Ww          , Ww          , Ww          , Ww          , Ww          , Ww          , Ww          , Wo          , Ww          , Ww          , Ss          , Wwf         , Ds          , Ds          , Ds          , Wwr         , Wwr         , Ww          , Ww^Vm       , Ww          , Wo          , Wo          , Wo          , Wo          , Wo          , Wo          , Wo          , Wo          , Ww          , Ww          , Ww          , Ww          , Ww          , Ss          , Ww          , Ss          , Ww          , Ss          , Ss          , Ss          , Ss
Ww          , Ww          , Ww          , Ww^Vm       , Ww          , Ww          , Wo          , Wo          , Wo          , Wo          , Ww          , Ww          , Ww          , Wwf         , Wwr         , Wwr         , Wwr         , Wwr         , Ww          , Ww          , Wo          , Wo          , Wo          , Wo          , Ww          , Wo          , Wo          , Wo          , Wo          , Ww          , Ww          , Ww          , Ww          , Ww          , Ss          , Ss          , Ss          , Ww          , Ss          , Ss          , Ww          , Ss
Wo          , Ww          , Ww          , Ww          , Ww          , Ww          , Wo          , Wo          , Wo          , Wo          , Wo          , Ww          , Ww          , Wwr         , Ww^Vm       , Wwr         , Ww          , Ww          , Wo          , Ww          , Wo          , Wo          , Ww          , Ww          , Ww^Vm       , Ww          , Wo          , Wo          , Wo          , Ww          , Wo          , Ww          , Ww          , Ww          , Wwr         , Wwr         , Ww          , Ss          , Ss          , Ss^Vhs      , Ss          , Ss
Wo          , Wo          , Wo          , Wo          , Wo          , Wo          , Wo          , Wo          , Wo          , Wo          , Wo          , Ww          , Ww          , Ww          , Ww          , Ww          , Ww          , Ww          , Wo          , Wo          , Ww          , Ww          , Wwf         , Wwf         , Wwf         , Ww          , Ww          , Wo          , Wo          , Wo          , Wo          , Wo          , Wo          , Ww          , Ww          , Ww          , Ww          , Ww          , Ww          , Ss          , Ss          , Ss
Wo          , Wo          , Wo          , Wo          , Wo          , Wo          , Wo          , Wo          , Wo          , Wo          , Wo          , Wo          , Wo          , Wo          , Wo          , Ww          , Wo          , Wo          , Wo          , Ww          , Ss          , Chs         , Ch          , Ds          , Ds          , Wwr         , Wwf         , Ww          , Ww          , Wo          , Wo          , Wo          , Wo          , Wo          , Ww          , Ww^Vm       , Ww          , Ww          , Ww          , Ww          , Ww          , Ww
Wo          , Wo          , Wo          , Wo          , Wo          , Wo          , Wo          , Wo          , Wo          , Wo          , Wo          , Wo          , Wo          , Wo          , Wo          , Wo          , Wo          , Wo          , Ww          , Ww          , Ss          , Khr         , Gg^Efm         , Gg          , Gs^Fp       , Ds          , Ds          , Wwr         , Ww          , Wo          , Wo          , Wo          , Wo          , Ww          , Ww          , Ww          , Ss          , Wwr         , Wwf         , Ww          , Ww          , Ww
Ww          , Ww          , Ww          , Ww          , Ww          , Wo          , Wo          , Wo          , Ww          , Wo          , Wo          , Wo          , Wo          , Wo          , Wo          , Wo          , Wo          , Wo          , Wo          , Ww          , Ww          , Ss^Vhs      , Ds          , Gs^Fms      , Ds          , Gg^Ve       , Ds          , Wwr         , Ww          , Wo          , Wo          , Wo          , Wo          , Ww          , Ww          , Ss^Vm       , Chs         , Ds          , Ds          , Wwr         , Ww          , Ww
Ww          , Ww^Vm       , Ww          , Ww          , Ww          , Wo          , Ww          , Ww          , Ww          , Ww          , Ww          , Ww          , Ww          , Wo          , Ww          , Wo          , Wo          , Wo          , Wo          , Ww          , Ww          , Wwr         , Wwf         , Ds          , Wwf         , Ds          , Wwr         , Wwr         , Ww          , Wo          , Wo          , Wo          , Ww          , Ww          , Ww^Vm       , Ss          , Chw         , 4 Kh        , Ds          , Wwr         , Ww          , Ww
Ss          , Ww          , Ss          , Ww          , Ww          , Ww          , Ww          , Ww          , Ww          , Ww          , Ww          , Ww^Vm       , Ww          , Ww          , Ww          , Wo          , Ww          , Wo          , Wo          , Wo          , Wo          , Ww          , Ww          , Wwr         , Ww          , Wwr         , Ww          , Ww          , Wo          , Wo          , Wo          , Wo          , Ww          , Ww          , Ww          , Wwf         , Wwf         , Chw         , Wwr         , Wwr         , Ww          , Ww
Ss          , Ss          , Ww          , Ss          , Ss          , Ww          , Ww          , Ww          , Ww          , Ww          , Ww          , Ww          , Ww          , Ww          , Ww          , Ww          , Ww          , Ww          , Ww          , Wo          , Wo          , Wo          , Wo          , Ww          , Wo          , Ww          , Wo          , Wo          , Wo          , Wo          , Wo          , Wo          , Ww          , Ww          , Ww          , Wwf         , Ww          , Wwf         , Ww          , Ww^Vm       , Ww          , Ww
Ss          , Ss          , Ss          , Ww          , Ss          , Ss          , Wwf         , Wwf         , Wwf         , Wwf         , Wwf^Bw\     , Ww          , Ww          , Ww          , Ww          , Ww          , Ss          , Wwr         , Wwr         , Ww          , Wo          , Wo          , Wo          , Wo          , Wo          , Wo          , Wo          , Wo          , Wo          , Wo          , Wo          , Wo          , Wo          , Wo          , Wo          , Ww          , Wo          , Ww          , Wo          , Ww          , Wo          , Ww
Gs^Fds      , Ss          , Gs^Fms      , Ss          , Ss          , Ss          , Cv          , Wwf         , Wwf         , Wwf         , Wwf^Bw/     , Wwf^Bw/     , Ww^Bw\      , Ww          , Ss          , Ww          , Ss          , Ss          , Wwr         , Ww          , Ww          , Wo          , Ww          , Wo          , Ww          , Wo          , Ww          , Wo          , Wo          , Wo          , Wo          , Wo          , Wo          , Wo          , Wo          , Wo          , Wo          , Wo          , Wo          , Wo          , Wo          , Wo
Gs^Fms      , Gs^Fmw      , Gg^Ve       , Gs^Fds      , Gs^Fms      , Cv          , 1 Kv        , Cv          , Wwf         , Wwf^Bw|     , Wwf         , Wwf         , Wwf         , Ww          , Ss          , Ss          , Ss          , Wwr         , Ww          , Ww^Vm       , Ww          , Ww          , Ww          , Ww          , Ww          , Ww          , Ww^Vm       , Ww          , Ww          , Ww          , Ww          , Wo          , Ww          , Wo          , Wo          , Wo          , Wo          , Wo          , Wo          , Wo          , Wo          , Wo
Gs^Fds      , Gg          , Gs^Fms      , Gs^Fms      , Rd          , Gs^Fms      , Rd          , Cv          , Rd          , Wwf^Bw/     , Ss          , Wwf         , Ss          , Ss          , Ss          , Ss^Vm       , Ss          , Wwr         , Ww          , Ww          , Ww          , Ww          , Ss          , Ww          , Ss          , Ww          , Ww          , Ww          , Ss          , Ww          , Ww          , Ww          , Ww          , Ww          , Ww          , Ww          , Ww          , Wo          , Ww          , Wo          , Ww          , Wo
Gs^Fds      , Gs^Fms      , Rd          , Rd          , Gs^Fms      , Rd          , Gg^Ve       , Rd          , Gs^Fms      , Gg          , Gs^Fds      , Gs^Fds      , Gs^Fp       , Ss          , Gg^Ve       , Gg          , Gs^Fds      , Ss          , Ss          , Ss          , Ss          , Ss          , Ss^Vhs      , Ss          , Ss          , Ww          , Ss          , Ss          , Ww          , Ss          , Ww          , Ww          , Ss          , Ww          , Ww          , Ww          , Ww          , Ww          , Ww          , Ww          , Ww          , Ww
Gs^Fms      , Gs^Fms      , Rd          , Gs^Fms      , Gs^Fds      , Gg^Efm         , Gs^Fms      , Gs^Fp       , Gs^Fms      , Gs^Fmw      , Gs^Fmw      , Gs^Fms      , Gg          , Gs^Fms      , Gg          , Gs^Fmw      , Gs^Fms      , Gs^Fds      , Gs^Fms      , Gs^Fms      , Ss          , Ss          , Ss          , Gs^Fms      , Gs^Fms      , Ss          , Ss          , Ss          , Ss          , Ss          , Ss          , Ss          , Ss          , Ss          , Ss          , Ww          , Ss          , Ss          , Ss          , Ww          , Ww          , Ww
