border_size=1
usage=map

Mm          , Mm          , Hh          , Hh^Fms      , Rr          , Hh^Fds      , Gs^Fds      , Hh^Vc       , Hh          , Mm          , Mm          , Mm^Xm       , Mm          , Mm          , Hh^Fp       , Hd          , Ww          , Ww          , Chw         , Rr          , Rr          , Ch          , Ww          , Gs^Fms      , Hh          , Mm          , Mm          , Mm^Xm
Hh^Fms      , Hh^Fp       , Hh^Fdw      , Hh^Fp       , Gs^Fds      , Rr          , Re          , Hh^Fms      , Hh^Fdw      , Hh^Fms      , Mm          , Mm          , Hh^Fdw      , Hh^Fdw      , Gs^Fdw      , Ss          , Ww          , Ww          , Chw         , 2 Kh        , Ch          , Wwf         , Rr          , Gg          , Gg          , Hh          , Mm          , Mm
Hh^Fms      , Gs^Fms      , Gs^Fms      , Hh^Fdw      , Gs^Fds      , Rd          , Rd          , Gs^Fds      , Gs^Fdw      , Hh          , Hh^Fms      , Hh^Fmw      , Gs^Fds      , Hh^Fdw      , Gg^Ve       , Ss          , Ww          , Ww          , Ww^Vm       , Chw         , Ww          , Ww          , Gg^Vh       , Rr          , Rd          , Hh^Fdw      , Hh          , Hh
Gs^Fds      , Gs^Fms      , Gg^Ve       , Gs^Fms      , Gg^Efm         , Re          , Re          , Rd          , Rd          , Gs^Fdw      , Gs^Fms      , Gs^Fds      , Gs^Fp       , Gs^Fds      , Gs^Fms      , Gs^Fdw      , Ww          , Ww          , Ww          , Ww          , Ww          , Ww          , Re          , Gg^Dr       , Rr          , Gg          , Hh^Fp       , Mm
Gs^Fp       , Re          , Gs^Fp       , Gs^Fdw      , Gs^Fms      , Gs^Fds      , Gs^Fp       , Re          , Rd          , Re^Dr       , Gg          , Gs^Fms      , Ww          , Ww          , Ww          , Ww          , Re          , Ww          , Ds          , Ww          , Dd^Vda      , Ds          , Re          , Rd          , Gg          , Rr          , Rd          , Hh^Fms
Gs^Fds      , Gs^Fms      , Gs^Fdw      , Gs^Fdw      , Ww          , Ww          , Ww          , Ww          , Ww^Bw|      , Ww          , Ww          , Ww          , Rd          , Rd          , Rd          , Gs^Fdw      , Rd          , Gs^Fms      , Rd          , Ds          , Rd          , Gs^Fdw      , Rd          , Rd          , Gs^Fds      , Hh^Fdw      , Hh^Fms      , Rd
Gs^Fp       , Gs^Fms      , Gg^Efm         , Ww          , Cv          , Cv          , Cv          , Gs^Fdw      , Rd          , Gs^Fms      , Rd          , Rd          , Gg^Efm         , Re          , Gg^Efm         , Rd          , Gs^Fmw      , Rd          , Re^Dr       , Rd          , Gg          , Rd          , Gs^Fms      , Gs^Fp       , Re          , Hh^Fms      , Gs^Fms      , Gs^Fms
Gs^Fds      , Gg^Ve       , Gs^Fds      , Ww          , Cv          , 4 Kv        , Cv          , Rd          , Gg          , Rd          , Re          , Gs^Fdw      , Gg          , Gg^Fet      , Gg^Efm         , Gs^Fds      , Gs^Fms      , Gs^Fdw      , Gs^Fmw      , Gs^Fms      , Gs^Fms      , Gg^Efm         , Gs^Fmw      , Gs^Fms      , Gs^Fds      , Gs^Fdw      , Gs^Fms      , Gs^Fms
Gs^Fms      , Gs^Fms      , Ww          , Ww          , Gg          , Cv          , Rd          , Rd          , Gs^Fdw      , Gg^Ve       , Gs^Fms      , Gs^Fp       , Gs^Fds      , Gg^Efm         , Gs^Fds      , Gs^Fmw      , Gs^Fms      , Re          , Gs^Fms      , Gs^Fds      , Gs^Fp       , Gs^Fds      , Gg^Ve       , Gs^Fms      , Gs^Fds      , Gs^Fp       , Gs^Fds      , Gs^Fms
Gg          , Gs^Fds      , Ww          , Gs^Fp       , Gs^Fds      , Rd          , Re          , Gs^Fmw      , Gs^Fms      , Gs^Fds      , Gs^Fds      , Gs^Fms      , Gs^Fms      , Gs^Fms      , Gs^Fms      , Gs^Fdw      , Gg          , Gs^Fms      , Gg          , Gs^Fms      , Gs^Fds      , Gs^Fds      , Gs^Fds      , Gs^Fms      , Gs^Fms      , Gs^Fp       , Gs^Fds      , Gs^Fp
Gg          , Gs^Fms      , Ww          , Gs^Fms      , Gs^Fms      , Rd          , Rd          , Gs^Fdw      , Gs^Fms      , Gs^Fms      , Gs^Fms      , Gg^Efm         , Gs^Fms      , Gs^Fms      , Gs^Fds      , Gs^Fp       , Gs^Fp       , Gs^Fms      , Gs^Fms      , Gs^Fp       , Gs^Fms      , Gs^Fms      , Gg^Efm         , Gg^Efm         , Gs^Fms      , Gg^Efm         , Gg          , Gg
Gs^Fds      , Gs^Fp       , Gg^Efm         , Ww          , Rd          , Rd          , Gg          , Rd          , Rd          , Rd          , Rd          , Gs^Fms      , Gs^Fms      , Gg          , Gs^Fms      , Gs^Fp       , Gg^Ve       , Gs^Fms      , Gs^Fms      , Gs^Fms      , Gs^Fms      , Gg          , Gs^Fms      , Gg^Efm         , Gg          , Gg          , Rd          , Rd
Gs^Fms      , Gs^Fms      , Ww          , Ww          , Rd          , Gs^Fms      , Gs^Fms      , Gs^Fms      , Gg^Ve       , Gg          , Gg          , Rd          , Gg          , Gs^Fp       , Gs^Fms      , Gg          , Gs^Fp       , Gs^Fms      , Gs^Fms      , Gg          , Gs^Fms      , Gs^Fp       , Gs^Fms      , Gg^Efm         , Gg          , Rd          , Gs^Fds      , Gg
Gg          , Ww          , Gs^Fp       , Gs^Fms      , Rd          , Gs^Fds      , Gs^Fms      , Gs^Fds      , Gs^Fp       , Gs^Fms      , Gs^Fms      , Rd          , Rd          , Gs^Fds      , Gg          , Gs^Fms      , Gs^Fms      , Gs^Fds      , Gs^Fms      , Gg          , Gs^Fp       , Gg^Ve       , Gs^Fms      , Gg          , Rd          , Rd          , Gg          , Gg
Ww          , Ww          , Gg^Ve       , Rd          , Gs^Fms      , Gs^Fms      , Gs^Fds      , Gs^Fms      , Gs^Fms      , Gs^Fms      , Gs^Fp       , Gs^Fms      , Gs^Fp       , Rd          , Rd          , Rd          , Rd          , Gs^Fds      , Gg          , Gs^Fms      , Gs^Fms      , Gs^Fms      , Gg          , Rd          , Gg          , Gs^Fds      , Gs^Fms      , Gg
Ww          , Gs^Fds      , Rd          , Rd          , Gs^Fds      , Gs^Fms      , Gs^Fds      , Gs^Fds      , Gs^Fp       , Gg^Efm         , Gs^Fds      , Gs^Fms      , Gs^Fms      , Gs^Fms      , Gs^Fms      , Gg          , Gg^Efm         , Rd          , Rd          , Rd          , Rd          , Gg          , Rd          , Rd          , Gs^Fds      , Gg          , Gg          , Gg
Rd          , Rd          , Gs^Fms      , Gs^Fp       , Gs^Fms      , Gs^Fms      , Ce          , Ce          , Ce          , Gs^Fp       , Gs^Fds      , Gg^Efm         , Gs^Fms      , Gs^Fms      , Gs^Fds      , Gs^Fds      , Gs^Fms      , Gs^Fms      , Gg^Ve       , Gg          , Ce          , Rd          , Rd          , Gg          , Gg          , Gg^Vh       , Gg          , Gg
Gs^Fms      , Gs^Fp       , Gs^Fms      , Gs^Fms      , Gs^Fms      , Gg          , Ce          , 3 Ke        , Ce          , Gg^Ve       , Gs^Fms      , Gs^Fms      , Gs^Fp       , Gs^Fp       , Gg          , Gs^Fms      , Gs^Fms      , Gs^Fms      , Gs^Fms      , Ce          , 1 Ke        , Ce          , Rd          , Gg          , Gg          , Gs^Fms      , Gg^Efm         , Gs^Fp
Gg          , Gs^Fds      , Gs^Fms      , Gs^Fds      , Gs^Fms      , Gs^Fms      , Gs^Fms      , Ce          , Gs^Fms      , Gs^Fms      , Gs^Fms      , Gs^Fms      , Gs^Fms      , Gs^Fds      , Gs^Fms      , Gg          , Gs^Fms      , Gs^Fds      , Gs^Fds      , Ce          , Gs^Fp       , Gs^Fp       , Gg          , Rd          , Rd          , Gg^Efm         , Gg          , Gg
Gg          , Gs^Fms      , Gs^Fms      , Gs^Fms      , Gs^Fms      , Gs^Fms      , Gs^Fms      , Gs^Fms      , Gg          , Gg          , Gs^Fms      , Gs^Fms      , Gs^Fms      , Gs^Fp       , Gs^Fms      , Gs^Fds      , Gs^Fms      , Gs^Fms      , Gs^Fms      , Gs^Fp       , Gs^Fms      , Gs^Fds      , Gg          , Gg          , Rd          , Gg          , Gg          , Gg
