border_size=1
usage=map

Xos, Xos, Xos, Xos, Xos, Xos, Xos, Xos, Xos, Xos, Xos, Xos, Xos, Xos, Xos, Xos, Xos, Xos, Xos, Xos, Xos, Xos, Xos, Xos, Xos, Xos, Xos, Xos, Xos, Xos, Xos, Xos, Xos, Xos, Xos, Xos, Xos
Xos, Xos, Xos, Xos, Xos, Xos, Xos, Xos, Xos, Xos, Xos, Xos, Xos, Xos, Xos, Xos, Xos, Xos, Xos, Xos, Xos, Xos, Xos, Xos, Xos, Xos, Xos, Xos, Xos, Xos, Xos, Xos, Xos, Xos, Xos, Xos, Xos
Xos, Xos, Xos, Xos, Xos, Xos, Xos, Xos, Xos, Xos, Xos, Xos, Xos, Xos, Xos, Xos, Xos, Xos, Xos, Xos, Xos, Xos, Xos, Xos, Xos, Xos, Xos, Xos, Iwr, Iwr, Iwr, Xos, Xos, Xos, Xos, Xos, Xos
Xos, Xos, Xos, Xos, Xos, Xos, Rr, Xos, Xos, Xos, Rr, Xos, Xos, Xos, Xos, Xos, Xos, Xos, Xos, Xos, Xos, Xos, Xos, Xos, Xos, Xos, Iwr, Iwr, Iwr, Iwr, Iwr, Iwr, Iwr, Xos, Xos, Xos, Xos
Xos, Xos, Xos, Xos, Xos, Rr, Rr, Rr, Xos, Rr, Rr, Rr, Xos, Xos, Xos, Xos, Xos, Xos, Xos, Xos, Xos, Xos, Xos, Xos, Xos, Xos, Xos, Iwr, Iwr, Iwr, Iwr, Iwr, Iwr, Iwr, Iwr, Xos, Xos
Xos, Xos, Xos, Xos, Xos, Xos, Xos, Rr^egG/, Rr, Rr^egG\, Xol, Xos, egDC, Rr, Rr, Xos, Xos, Xos, Xos, Xos, Xos, Xos, Xos, Xos, Xos, Xos, Rr, Xos, Xos, Iwr, Iwr, Iwr, Iwr, Iwr, Xos, Xos, Xos
Xos, Xos, Xos, Xos, Rr, Rr, Rr, Rr^egG\, Xos, Rr, Rr, Xol, Rr^egG\, Rr, Xos, Xos, Rr, Xos, Xos, Xos, Xos, Xos, Xos, Xos, Xos, Xos, Xos, Rr^egG/, Rr, Rr^egG\, Rr^egG\, Iwr, Xos, Xos, Xos, Xos, Xos
Xos, Xos, Xos, Xos, Xos, Rr, Xos, Xos, Rr, Xos, Rr^egG\, Rr, Rr, Xol, Xol, egDC, Rr, Rr, Xos, Xos, Xos, Xos, Xol, Xos, Rr, Xos, Rr^egG\, Rr, Rr, Rr, Rr^egG/, Xos, Xos, Xos, Xos, Xos, Xos
Xos, Xos, Xos, Xos, Xos, Xos, Xos, Rr, Rr, egDC, Xos, Xos, Xos, Rr, Rr, Rr^egG\, Xos, Xos, Xos, Xos, Xos, Xol, Rr, Rr, Rr, Rr, Rr, Rr^egG\, Xos, Xos, Xos, Rr, Xos, Xos, Xos, Xos, Xos
Xos, Xos, Xos, Xos, Xos, Xos, Xos, Xos, Xos, Xos, Rr, Rr, egDC, Rr^egG\, Xol, Rr^egG/, Rr, Xos, Xos, Xos, Xos, Rr, Rr, Cud, Rr, Rr, Rr, Rr, Rr, Xos, Xos, Xos, Xos, Xos, Xos, Xos, Xos
Xos, Xos, Xos, Xos, Xos, Xos, Xos, Xos, Xos, Xos, Xos, Rr, Xos, Xol, Rr, Rr, Rr, Cud, Cud, 2 Kud, Cud, Cud, Rr, Rr, Rr, Cud, Rr, Rr, Xos, Xos, Xos, Xos, Xos, Xos, Xos, Xos, Xos
Xos, Xos, Xos, Xos, Xos, Xos, Xos, Xos, Xos, Xos, Xos, Xos, Xos, Rr, Cud, Rr, Rr, Rr, Rr, Cud, Rr, Rr, Rr, Rr, Rr, Rr, Xos, Xos, Xos, Xos, Xos, Xos, Xos, Xos, Xos, Xos, Xos
Xos, Xos, Xos, Xos, Xos, Xos, Xos, Xos, Xos, Xos, Xos, Xos, Xol, Xol, Rr^egG\, Cud, Cud, Rr, Rr, Rr, Rr, Rr, Rr, Rr, Xos, Xos, Rr, Xos, Xos, Xos, Xos, Xos, Xos, Xos, Xos, Xos, Xos
Xos, Xos, Xos, Xos, Xos, Xos, Xos, Xos, Xos, Xos, Xol, Xos, Rr, Rr, Rr, Rr^egG\, Rr^egG\, Cud, Cud, Rr, Rr, Rr, Rr^egG/, Xos, Rr^egG\, egDC, Rr, Rr, Xos, Xos, Xos, Xos, Xos, Xos, Xos, Xos, Xos
Xos, Xos, Xos, Xos, Xos, Xos, Xos, Xos, Xos, Xol, Rr, Cud, Rr, Rr, Rr, Rr, Xos, Xos, Xos, Rr, Xos, Xos, Rr^egG\, Rr, Rr, Xol, Xol, Xos, egDC, Rr, Rr, Xos, Xos, Xos, Xos, Xos, Xos
Xos, Xos, Xos, Xos, Xos, Xos, Xol, Xol, Rr, Rr^egG\, Rr^egG\, Rr, Rr, Cud, Xos, Xos, Xos, Xos, Xos, Xos, Rr, Rr, egDC, Xos, Xos, Rr, Rr, Rr^egG\, Xol, Rr, Xos, Xos, Rr, Xos, Xos, Xos, Xos
Xos, Xos, Xos, Xos, Xos, Xos, Rr, Rr, Ww, Rr, Rr, Rr^egG\, Xos, Xos, Xos, Xos, Xos, Xos, Xos, Xos, Xos, Rr, Xos, Xos, Rr, Rr^egG\, Xos, Rr, Rr, Xol, Rr^egG\, egDC, Rr, Rr, Xos, Xos, Xos
Xos, Xos, Xos, Xos, Xos, Xos, Rr, Ww, Ww, Ww, Ww, Rr, Rr, Xos, Xos, Xos, Xos, Xos, Xos, Xos, Xos, Xos, Xos, Rr, Rr, egDC, Xos, Xos, Rr^egG\, Rr, Rr^egG/, Xos, Xos, Xos, Xos, Xos, Xos
Xos, Xos, Xos, Xos, Xos, Xos, Rr, Ww, Ww, Ww, Ww, Ww, Rr, Rr, Xos, Xos, Xos, Xos, Xos, Xos, Xos, Xos, Xos, Xos, Xos, Xos, Rr, Rr, egDC, Xos, Rr, egDC, Rr, Xos, Xos, Xos, Xos
Xos, Xos, Xos, Xos, Rr, Rr^egG\, Xos, Rr, Rr, Ww, Rr, Rr, Xos, Rr^egG/, Rr, Xos, Xos, Xos, Xos, Xos, Xos, Xos, Xos, Xos, Xos, Xos, Xos, Rr, Xos, Xos, Xos, Rr, Xos, Xos, Xos, Xos, Xos
Xos, Xos, Xos, Xos, Rr, Xos, Xos, Xos, Xos, Rr, Xos, Xos, Xos, Xos, Rr, Xos, Xos, Xos, Xos, Xos, Xos, Xos, Xos, Xos, Xos, Xos, Xos, Xos, Xos, Xos, Xos, Xos, Xos, Xos, Xos, Xos, Xos
Xos, Xos, Xos, Xos, Xos, Rr^egG/, Iwr, Xol, Xol, Xos, Xol, Xol, Iwr, Rr^egG\, Xos, Xos, Xos, Xos, Xos, Xos, Xos, Xos, Xos, Xos, Xos, Xos, Xos, Xos, Xos, Xos, Xos, Xos, Xos, Xos, Xos, Xos, Xos
Xos, Xos, Xol, Xol, Iwr, Iwr, Iwr, Iwr, Iwr, Xos, Iwr, Iwr, Iwr, Iwr, Iwr, Xol, Xol, Xos, Xos, Xos, Xos, Xos, Xos, Xos, Xos, Xos, Xos, Xos, Xos, Xos, Xos, Xos, Xos, Xos, Xos, Xos, Xos
Xos, Xos, Iwr, Iwr, Iwr, Iwr, Iwr, Iwr, Iwr, Xos, Iwr, Iwr, Iwr, Iwr, Iwr, Iwr, Iwr, Xos, Xos, Xos, Xos, Xos, Xos, Xos, Xos, Xos, Xos, Xos, Xos, Xos, Xos, Xos, Xos, Xos, Xos, Xos, Xos
Xos, Xos, Xos, Iwr, Iwr, Iwr, Iwr, Iwr, Rr^egG/, Xos, Rr^egG\, Iwr, Iwr, Iwr, Iwr, Iwr, Xos, Xos, Xos, Xos, Xos, Xos, Xos, Xos, Xos, Xos, Xos, Xos, Xos, Xos, Xos, Xos, Xos, Xos, Xos, Xos, Xos
Xos, Xos, Xos, Xos, Xos, Iwr, Xos, Rr^egG/, Rr, Rr, Rr, Rr^egG\, Xos, Iwr, Xos, Xos, Xos, Xos, Xos, Xos, Xos, Xos, Xos, Xos, Xos, Xos, Xos, Xos, Xos, Xos, Xos, Xos, Xos, Xos, Xos, Xos, Xos
Xos, Xos, Xos, Xos, Xos, Xos, Xol, Xos, Rr^egG\, Rr, Rr, Rr, Rr, Xos, Xos, Xos, Xos, Xos, Xos, Xos, Xos, Xos, Xos, Xos, Xos, Xos, Xos, Xos, Xos, Xos, Xos, Xos, Xos, Xos, Xos, Xos, Xos
Xos, Xos, Xos, Xos, Xos, Xol, Iwr, Iwr, Iwr, Rr^egG\, Rr^egG\, Rr, Xos, Xos, Xos, Xos, Xol, Xos, Iwr, Iwr, Iwr, Xos, Xos, Xos, Xos, Xos, Iwr, Iwr, Iwr, Xos, Xol, Xos, Xos, Xos, Xos, Xos, Xos
Xos, Xos, Xos, Xos, Iwr, Iwr, Iwr, Iwr, Iwr, Iwr, Iwr, Xos, Xos, Xos, Xos, Xol, Iwr, Iwr, Iwr, Iwr, Iwr, Iwr, Iwr, Xos, Iwr, Iwr, Iwr, Iwr, Iwr, Iwr, Iwr, Xol, Xos, Xos, Xos, Xos, Xos
Xos, Xos, Xos, Xos, Xos, Iwr, Iwr, Iwr, Iwr, Iwr, Iwr, Xos, Xos, Xos, Iwr, Iwr, Iwr, Iwr, Iwr, Iwr, Iwr, Iwr, Xos, Xol, Xos, Iwr, Iwr, Iwr, Iwr, Iwr, Iwr, Iwr, Iwr, Xos, Xos, Xos, Xos
Xos, Xos, Xos, Xos, Xos, Xos, Xos, Iwr, Iwr, Iwr, Iwr, Xos, Xos, Iwr, Iwr, Iwr, Iwr, Iwr, Iwr, Iwr, Rr^egG/, Rr^egG/, Rr, Rr, Rr, Rr^egG\, Rr^egG\, Iwr, Iwr, Iwr, Iwr, Iwr, Iwr, Iwr, Xos, Xos, Xos
Xos, Xos, Xos, Xos, Xos, Xos, Xol, Xos, Rr^egG\, Iwr, Iwr, Xos, Xos, Xos, Xos, Iwr, Iwr, Iwr, Xos, Rr^egG/, Rr, Rr, Rr, Rr, Rr, Rr, Rr, Rr^egG\, Xos, Iwr, Iwr, Iwr, Xos, Xos, Xos, Xos, Xos
Xos, Xos, Xos, Xos, 9 Kud, Cud, Rr, Rr, Rr, Rr^egG\, Xos, Xos, Xos, Xos, Xos, Xos, Xos, Xos, Iwr, Xos, Rr^egG\, Rr, Rr, Rr, Rr, Rr, Rr, Rr, Xos, Xos, Xos, Xos, Xos, Xos, Xos, Xos, Xos
Xos, Xos, Xos, Xos, Xos, Rr, Rr, Rr, Rr, Cud, Rr, Xos, Xos, Xos, Xos, Xos, Iwr, Iwr, Iwr, Iwr, Iwr, Rr^egG\, Xos, Rr, Rr, Cud, Rr, Rr, Xos, Xos, Xos, Xos, Xos, Xos, Xos, Xos, Xos
Xos, Xos, Xos, Xos, Xos, Xos, Xos, Cud, Rr, Rr, Rr, Rr, Rr, Xos, Xos, Iwr, Iwr, Iwr, Iwr, Iwr, Iwr, Iwr, Xos, Cud, Rr, Rr, Rr, Cud, Xos, Xos, Xos, Xos, Xu, Xu, Xu, Xos, Xos
Xos, Xos, Xos, Xos, Xos, Xos, Xos, Xos, Xos, Rr, Rr, Rr, Rr, Cud, Rr, Rr^egG\, Rr^egG\, Iwr, Iwr, Iwr, Xos, Xos, Xos, Rr, Rr^egG/, Xos, Rr^egG\, Rr, Xos, Xos, Xu, Xu, Iwr, Iwr, Iwr, Xu, Xu
Xos, Xos, Xos, Xos, Xol, Xos, Xos, Xos, Xos, Xos, Xos, Cud, Rr, Rr, Rr, Rr, Xos, Xos, Xos, Xos, Xos, Xos, Xos, Rr^egG/, Rr, Rr, Rr, Rr^egG\, Xos, Xos, Xos, Iwr, Iwr, Iwr, Iwr, Iwr, Xu
Xos, Xos, Xos, Xol, Rr, Rr, Rr, Xos, Xol, Xos, Xos, Xos, Xos, Rr, Xos, Xos, Xos, Xos, Xos, Xos, Rr^egG\, Rr, Xos, Rr, Rr, Rr, Rr, Rr, Xos, Rr, Rr, Rr^egG\, Rr^egG\, Iwr, Iwr, Iwr, Xu
Xos, Xos, 3 Kud, Cud, Rr, Cud, Rr, Rr, Rr, Xol, Xos, Xos, Rr, Xos, Rr, Cud, Rr, Xos, Rr, Rr, Rr, Xos, Rr, Rr, Rr, Rr, Rr, Rr, Xos, Rr, Rr, Rr, Xos, Xos, Xu, Xu, Xos
Xos, Xos, Cud, Cud, Rr, Rr, Rr, Rr, Rr, Rr, Cud, Rr^egG\, Rr^egG\, Rr, Rr, Rr, Rr, Rr, Rr, Rr, Rr, Rr, Rr, Rr, Rr, Rr, Rr, Rr, Xos, Xos, Rr^egG/, Rr^egG/, Iwr, Xu, Xu, Xos, Xos
Xos, Xos, Rr, Rr, Rr, Rr, Rr, Rr, Rr, Rr, Rr, Rr, Cud, Rr^egG\, Xos, Cud, Xos, Rr, Rr, Rr, Xos, Rr, Xos, Rr, Rr, Rr, Rr, Rr, Xos, Xos, Iwr, Iwr, Iwr, Iwr, Iwr, Xu, Xu
Xos, Xos, Rr^egG\, Rr, Rr, Cud, Rr, Rr, Rr, Rr, Rr, Rr, Xos, Xos, Xos, Xos, Xos, Xos, Xos, Rr, Rr, Xos, Xos, Rr, Rr, Rr, Rr, Rr, Xos, Xu, Xu, Iwr, Iwr, Iwr, Iwr, Iwr, Xu
Xos, Xos, Rr, Xos, Xos, Rr, Rr, Rr, Rr, Rr, Xos, Xos, Xos, Xos, Xos, Xos, Iwr, Xos, Rr^egG\, Rr, Xos, Xos, Xos, Ur, Rr, Rr, Ur, Rr, Xu, Xos, Xos, Xu, Xu, Iwr, Xu, Xu, Xos
Xos, Xos, Rr, Xos, Xos, Xos, Xos, Rr, Xos, Xos, Xos, Xos, Xos, Xos, Iwr, Iwr, Iwr, Iwr, Iwr, Xos, Xos, Xos, Xu, Ur, Ur, Ur, Ur, Uu, Uu^Uf, Xu, Xos, Xos, Xos, Xu, Xos, Xos, Xos
Xos, Xos, Xos, Xos, Xos, Xos, Xos, Xos, Xos, Xos, Xos, Xos, Xos, Xos, Xos, Iwr, Iwr, Iwr, Iwr, Iwr, Xos, Xos, Xu, Uu, Uu, Ur, Ur, Uu, Uu, Xu, Xu, Xos, Xos, Xos, Xos, Xos, Xos
Xos, Xos, Xos, Xos, Xos, Xos, Xos, Xos, Xos, Xos, Xos, Xos, Xos, Xos, Xos, Xos, Xos, Iwr, Xos, Xos, Xos, Xos, Xos, Xu, Uu^Emf, Ur, Ur, 1 Ur, Ur, Uu, Uu^Emf, Xu, Xos, Xos, Xos, Xos, Xos
Xos, Xos, Xos, Xos, Xos, Xos, Xos, Xos, Xos, Xos, Xos, Xos, Xos, Xos, Xos, Xos, Xos, Xos, Xos, Xos, Xos, Xos, Xos, Xu, Xu, Uu, Uu, Ur, Ur, Uu, Uu, Xu, Xos, Xos, Xos, Xos, Xos
