Gs^Fds, Gs^Fms, Gg, Gs^Fms, Gs^Fds, Gs^Fms, Rp, Rp, Gs^Fds, Gs^Fds, Gs^Fms, Ww, Ww, Gs^Fms, Gs^Fms, Gg, Gg, Gg, Gs^Fms, Gs^Fms, Ww, Gg, Gs^Fms, Gll^Fp, Gll^Fp, Gs^Fms, Gs^Fms, Gg, Gll, Gll, Gll^Fp, Gs^Fms, Rb, Gs^Fms, Gs, Gg, Gs, Gg, Rb, Gs, Rb, Gs^Fms
Gs^Fds, Gs^Fms, Gg^Ve, Gll^Fp, Gs^Fds, Gs^Fds, Rp, Gs^Fms, Gs^Fms, Gs^Fms, Gg^Es, Ww, Gs^Fms, Gs^Fms, Gg^Efm, Gs^Fds, Hh^Fp, Hh^Fds, Gs^Fms, Gg^Es, Ww, Gs^Fms, Gs^Fms, Gs^Fds, Gll^Fp, Gs^Fds, Gd, Gll, Gs^Fms, Gs^Fms, Gs^Fds, Gs^Emf, Rb^Em, Rb, Gd, Re, Rb, Rb, Gs, Re, Rb, Rb
Gs^Fms, Gll^Fp, Gs^Fms, Gg^Efm, Gs^Fms, Gs^Fms, Rp, Gs^Fms, Ww, Gs^Fds, Ww, Ww, Gs^Fds, Gll^Fp, Gs^Fds, Gg, Hh^Fms, Gll^Fp, Gg^Ve, Ww, Rp, Gs^Fms, Gll, Gs^Fds, Gll, Gll, Gll, Gll, Gg, Gg^Em, Gs^Em, Gd^Vo, Gd^Em, Rb, Re^Es, Re, Rb, Rb, Rb, Rb, Rb, Rb
Rp, Rp, Rp, Rp, Rp, Rp, Ww^Bsb\, Ww, Cv, Ww, Ww, Gs^Fms, Gs^Fms, Gs^Fms, Rp, Gs^Fms, Rp, Gs^Fms, Rp, Wwf, Ww, Rp, Gs^Fms, Rp, Gs^Fms, Gg, Gs^Fms, Gg, Gs^Fms, Gg, Rb, Rb^Em, Rb^Edt, Rb^Edb, Co, Rb^Edt, Re^Edb, Rb^Em, Rb^Emf, Re, Rb, Gs
Gs^Fms, Gs^Fms, Gll^Fp, Gs^Fms, Ww, Ww^Bsb\, Cv, Cv, Gg^Ve, Cv, Cv, Ww, Ww^Bsb/, Rp, Gs^Fms, Rp, Gs^Fms, Rp, Hh^Fds, Hh^Fds, Gg, Ww, Gs^Fms, Gs^Fms, Gs^Fms, Gg, Gg, Gs^Em, Gd^Vo, Gs^Em, Gs, Re, Rb^Edb, Co, Co, 4 Ko, Co, Gd^Vo, Re^Em, Rb, Rb, Gd
Gs^Fms, Gg^Em, Gg^Em, Gll^Fp, Ww, Cv, 3 Kv, Gg^Fp, Gg^Fet, Gg^Efm, 1 Kv, Cv, Ww, Gs^Fms, Gs^Fms, Gs^Fds, Gg^Efm, Gs^Fms, Hh^Fms, Hh^Fds, Ww, Ww, Gs^Fms, Gll^Fp, Gg, Gs^Fms, Gs^Fms, Gg^Emf, Gs^Em, Gd^Em, Re, Re, Rb^Edt, Co, Co, Co, Co, Rb^Edb, Rb, Gd, Re, Re
Gs^Fms, Gs^Fds, Gs^Fms, Gs^Fms, Ww, Cv, Cv, Gs^Fds, Gg^Ve, Gs^Fms, Cv, Cv, Ww, Gll^Fp, Gll^Fp, Gg^Ve, Hh^Fds, Hh^Fds, Hh^Fds, Hh^Fp, Ww, Gs^Fms, Gs^Fds, Gg, Gg^Efm, Gs^Fms, Hh^Fms, Gg, Gs, Gd, Gd, Re, Gd, Rb^Edb, Rb^Edt, Co, Gd^Edb, Rb^Edt, Re, Gd, Gg, Gg
Ww, Gs^Fms, Ww, Gs^Fms, Ww, Ww, Ww, Cv, Cv, Cv, Ww, Ww, Ww, Gs^Fms, Gs^Fms, Gg^Efm, Gs^Fms, Gs^Fms, Ww, Ww, Gg, Gs^Fms, Gll^Fp, Gs^Fds, Gs^Fds, Hh^Fds, Hh^Fds, Gs^Fms, Gs, Gs, Gs, Gd, Re, Re, Gd, Rb, Re, Gs, Rb^Esd, Gs^Em, Gg^Emf, Gg
Gs^Fms, Ww, Gs^Fms, Ww, Gs^Fms, Gs^Fms, Gs^Fms, Ww, Ww^Bsb|, Ww, Gs^Fms, Gs^Fms, Gs^Fms, Ww, Gs^Fms, Gs^Fms, Gs^Fms, Gs^Fms, Ww, Gs^Fms, Gg, Gs^Fms, Gs^Fds, Hh^Fp, Hh^Fds, Hh^Fp, Hh^Fds, Gll^Fp, Gg, Gll^Fp, Gs^Fms, Rb, Gs, Re, Re, Re, Gg, Gs, Rb^Esd, Gd^Vo, Gg^Em, Gg
Gs^Fms, Gs^Fms, Gs^Fds, Gs^Fds, Gs^Fms, Gs^Fms, Gs^Fms, Gs^Fms, Rp, Gg, Gs^Fms, Gs^Fms, Gs^Fds, Ww, Ww, Ww, Ww, Ww, Ww, Ww, Ww, Gs^Fms, Gs^Fms, Hh^Fds, Gs^Fds, Hh^Fds, Hh^Fms, Gg, Gs^Fms, Hh^Fp, Gg, Gs, Gs, Gs^Fms, Gg^Em, Gs, Re, Gs^Fds, Gg, Gg^Em, Gg, Gg
Gs^Fms, Gg, Gs^Fms, Gs^Fms, Gg^Ve, Gs^Fms, Gs^Fms, Rp, Gg, Gg, Gs^Fms, Gs^Fms, Gs^Fds, Gs^Fms, Gs^Fds, Gs^Fms, Ww^Ewl, Ww, Wo, Wo, Ww, Ww^Vm, Gs^Fms, Gs^Fms, Gg, Gll^Fp, Gs^Fds, Hh^Fms, Gg, Gs^Fds, Gs^Fds, Gll^Fp, Gg, Gs^Fds, Gd^Vo, Gs^Fds, Gg, Gg, Gs^Fms, Gg, Gg, Gg
Gs^Fms, Gs^Fms, Gg^Efm, Gg^Efm, Gs^Fms, Gs^Fms, Gs^Fms, Rp, Gg, Gs^Fms, Gs^Fms, Gg, Gs^Fms, Gs^Fds, Gs^Fms, Gs^Fms, Gs^Fms, Ww, Ww, Wo, Ww, Ww, Ww, Gs^Fms, Gs^Fms, Gs^Fms, Gg, Gs^Fds, Gs^Fms, Gs^Fms, Gg, Gs^Fms, Gs^Fms, Gs^Fms, Gg^Em, Gg^Emf, Gg, Gs^Fms, Gg, Gg, Gs, Gg
Gs^Fms, Gs^Fds, Gs^Fds, Gs^Fds, Gs^Fms, Gg, Gg, Rp, Gs^Fms, Gs^Fms, Gll^Fp, Gs^Fms, Gg^Efm, Gs^Fms, Gll^Fp, Gs^Fds, Gs^Fds, Ww^Ewl, Gg, Ww, Gs^Fms, Wwr, Wwr, Gs^Fms, Ww, Gs^Fms, Ww, Gs^Fms, Gs^Fms, Gs^Fms, Gg, Gg, Gg, Gg, Gg, Gs^Fms, Gg, Gll^Fp, Gg, Gg, Gg, Gg
Gs^Fms, Gs^Fms, Gll^Fp, Gs^Fds, Gs^Fms, Gs^Fms, Rp, Rp, Gs^Fms, Gll^Fp, Gll^Fp, Gg^Ve, Gs^Fms, Gs^Fms, Gs^Fds, Gs^Fms, Gs^Fds, Gs^Fms, Gg, Gs^Fms, Gs^Fms, Ww, Ww, Ww, Ww, Ww, Ww, Ww, Ww, Gs^Fms, Gs^Fms, Gg, Gg, Gs^Fds, Gg, Gs^Fds, Gg, Gg, Gs, Gg^Efm, Gg^Efm, Gg
Gs^Fds, Gg, Gs^Fms, Gs^Fms, Gs^Fms, Gg, Rp, Gg, Gs^Fms, Gs^Fms, Gs^Fds, Gs^Fds, Hh^Fp, Hh^Fds, Hh^Fms, Hh^Fds, Gs^Fms, Gs^Fms, Gs^Fds, Gs^Fms, Gs^Fms, Gs^Fms, Gs^Fms, Ww, Gs^Fms, Ww, Gs^Fms, Ww, Ww, Ww, Gs^Fms, Gs^Fms, Gg, Gg^Efm, Gs^Fds, Gg, Gg, Gs^Fms, Gg, Gg^Efm, Gs, Gg
Gs^Fds, Gs^Fds, Gll^Fp, Gs^Fms, Gs^Fms, Gs^Fms, Gg, Rp, Gs^Fms, Gll^Fp, Gs^Fms, Gs^Fms, Hh^Fds, Hh^Fp, Hh^Fds, Hh^Fds, Gg, Gs^Fms, Gg, Gs^Fds, Gll^Fp, Gg, Gs^Fds, Gs^Fms, Gs^Fds, Gg, Gs^Fms, Gs^Fms, Ww, Ww, Ww, Gs^Fms, Gs^Fms, Gg, Gg, Gs^Fms, Gg, Gg, Gll^Fp, Gg, Gg, Gg
Gs^Fms, Gll^Fp, Gg^Ve, Gs^Fds, Gs^Fds, Gs^Fms, Rp, Rp, Gg, Gs^Fms, Gs^Fms, Gg, Hh^Fds, Hh^Fds, Gg, Gs^Fms, Gg, Gs^Fms, Gs^Fms, Gs^Fms, Gs^Fms, Gs^Fms, Gg, Gs^Fms, Gs^Fds, Gs^Fms, Gs^Fds, Gs^Fds, Gs^Fms, Ww, Ww, Ww, Gs^Fms, Gg, Gs^Fms, Gs^Fms, Gg, Gs^Fds, Gg, Gg, Gg, Gg
Gg, Gs^Fms, Gs^Fms, Gs^Fms, Cv, Gs^Fms, Rp, Gs^Fms, Gs^Fms, Gs^Fms, Gs^Fds, Gs^Fms, Gs^Fms, Gg^Efm, Gs^Fms, Gg, Gg, Gs^Fms, Gg^Efm, Gg^Ve, Gg^Efm, Gll^Fp, Gs^Fms, Gg, Gg^Efm, Gs^Fds, Gs^Fms, Gs^Fms, Gs^Fms, Gs^Fms, Ww, Ww, Ww, Gs^Fms, Gs^Fms, Gg, Gg^Gvs, Gg^Gvs, Gs^Fds, Gg, Gg^Efm, Gg
Gs^Fms, Gs^Fms, Gs^Fms, Cv, 5 Kv, Cv, Rp, Gs^Fds, Gs^Fds, Gs^Fms, Gg^Ve, Gg^Efm, Gg, Gg^Efm, Gs^Fds, Gs^Fms, Gs^Fds, Gs^Fms, Gs^Fms, Gg^Efm, Gs^Fms, Gs^Fds, Gll^Fp, Gll^Fp, Gs^Fms, Gg^Ve, Gs^Fds, Gg, Gs^Fms, Ww, Gs^Fms, Gll^Fp, Gs^Fms, Ww, Gg, Gs^Fms, Gg^Gvs, Gs^Vh, Gg^Gvs, Gs^Fds, Gg, Gg
Gs^Fms, Gll^Fp, Gll^Fp, Cv, Cv, Cv, Rp, Gs^Fms, Gg, Gs^Fds, Gs^Fds, Gs^Fms, Gg, Gs^Fms, Gs^Fds, Gs^Fds, Gg^Efm, Gs^Fms, Gll^Fp, Gs^Fms, Gs^Fds, Gs^Fms, Gg, Gs^Fms, Hh^Fp, Gs^Fms, Gs^Fms, Gg, Hh^Fp, Ww, Gs^Fms, Gs^Fds, Gs^Fds, Ww, Ww, Gg, Gg, Gs^Gvs, Gs, Gs, Gg, Gg
Gs^Fms, Gll^Fp, Gs^Fms, Gg, Rp, Rp, Gg, Gs^Fms, Gs^Fms, Gs^Fds, Gs^Fms, Gs^Fms, Gs^Fms, Gs^Fds, Gg, Gs^Fms, Gs^Fds, Gg, Gs^Fms, Gg, Gs^Fds, Gs^Fms, Gs^Fms, Gg, Hh^Fms, Hh^Fds, Gs^Fds, Hh^Fds, Ww, Ww, Gg, Gg^Efm, Gs^Fms, Gs^Fms, Ww, Gs^Fms, Gg, Gg, Gg, Gg, Re, Re
Gs^Fms, Gs^Fms, Gs^Fds, Gg, Rp, Gg, Gs^Fms, Gs^Fds, Gs^Fds, Gs^Fds, Hh^Fp, Gg, Gs^Fds, Gg, Hh^Fds, Gg, Gs^Fms, Gs^Fds, Gs^Fds, Gg, Gs^Fms, Hh^Fp, Hh^Fds, Hh^Fms, Hh^Fp, Hh^Fds, Gs^Fms, Gg, Ww, Gs^Fms, Gs, Gg, Gg, Ww, Gg, Gll^Fp, Gg, Gs^Fms, Re, Gg, Gg, Re
Rp, Rp, Rp, Rp, Gs^Fms, Gs^Fms, Gs^Fms, Hh^Fp, Hh^Fp, Hh^Fds, Hh^Fms, Hh^Fds, Gs^Fds, Hh^Fds, Gll^Fp, Gs^Fms, Gg^Ve, Gs^Fms, Gs^Fms, Gs^Fds, Gs^Fds, Gs^Fds, Gs^Fms, Hh^Fp, Gs^Fds, Gs^Fms, Gs^Fms, Ww, Gs^Fms, Gs^Fms, Gg, Gs^Fms, Ww, Ww, Gs^Fms, Gg, Gs^Fds, Gg, Gs^Em, Re, Ww^Ewf, Ww
Gg, Gs^Fms, Gs^Fms, Gs^Fds, Gs^Fds, Gg^Ve, Gs^Fms, Gs^Fds, Gs^Fms, Gg, Hh^Fds, Hh^Fds, Gs^Fds, Gs^Fms, Gg, Gs^Fds, Gs^Fms, Gs^Fds, Gg, Gs^Fds, Gg, Gs^Fms, Gg, Gs^Fms, Gs^Fms, Gs^Fms, Gs^Fms, Ww, Gg^Em, Gs^Emf, Gg^Em, Gg, Ww, Gg^Gvs, Gs^Gvs, Re, Gs, Re^Esd, Gs^Vc, Re^Esd, Ww, Ww
Gs^Fms, Gs^Fms, Gll^Fp, Gs^Fds, Gs, Gll^Fp, Gs^Fds, Gll^Fp, Gs, Gs^Fms, Hh^Fp, Gs^Fds, Gs^Fms, Gs^Fds, Gg, Gs^Fms, Gs^Fds, Gs^Fms, Gg, Gs^Fms, Gs^Fms, Gs^Fms, Gs^Fms, Gll^Fp, Gs^Fms, Gg, Ww, Ww, Gg^Em, Gs^Vc, Gg^Em, Ww, Gg^Gvs, Gs^Vh, Gs^Gvs, Gs, Re, Re^Esd, Gg^Emf, Ww^Ewl, Ww, Ww
Gs^Fds, Gs^Fds, Gg, Hh^Fp, Gg, Gg, Gs, Gs^Fms, Gg, Gll^Fp, Gs^Fds, Gg, Gs^Fms, Gg, Gs^Fms, Gs^Fms, Ww, Gs^Fms, Ww, Gg, Ww, Ww, Ww, Gs^Fms, Gg, Gll^Fp, Ww, Gll^Fp, Gg, Gs^Fds, Gs^Fms, Wwf, Re, Re^Esd, Ce, Re, Re^Esd, Gg^Em, Ww^Ewl, Ww, Wo, Wo
Gs^Fms, Gs^Fms, Gs^Fms, Gg, Gg, Gs^Fms, Gs^Fds, Gs, Gs^Fms, Gll^Fp, Gg^Emf, Gg, Gs^Fms, Gs^Fms, Ww, Ww, Gs^Fms, Ww, Gs^Fms, Ww, Gs^Fms, Gs^Fms, Gs^Fms, Ww, Gs^Fms, Gs^Fds, Gs^Fms, Ww, Ww, Gs^Fds, Ww, Wwf, Re, Ce, Ce, Ce, Gs^Vl, Ww^Ewf, Ww, Ww, Wo, Wo
Gs^Fms, Gg^Efm, Gg, Gg, Gs^Fms, Gs, Gs, Gs, Gll^Fp, Gs^Em, Gd^Vo, Gs^Fms, Ww, Ww, Gs^Fms, Gs^Fms, Gg, Gs^Fms, Gs^Fms, Gs^Fms, Hh^Fp, Gs^Fds, Gg, Ww, Ww, Ww, Ww, Gs^Fds, Gll^Fp, Ww, Ww, Ww^Vm, Re, Ce, Ce, 2 Ket, Re^Esd, Ww^Ewl, Ww, Ww, Ww, Ww
Gg, Gg, Gg, Gs, Gll^Fp, Gs^Fms, Gg, Gs^Fms, Gg, Gg^Em, Gg^Em, Gs^Fms, Ww, Gs^Fms, Gs, Gg, Gs^Fms, Gg, Gs, Gs, Gg, Gs, Gs^Fms, Gs^Fms, Gs^Fms, Gs^Fms, Ww, Gs^Fms, Gs^Fms, Ww, Ww, Ww, Ww, Ce, Ce, Ce, Ww^Ewl, Ww, Ww, Ww, Ww, Ww
Gs^Fms, Gg, Gg, Gs, Gll^Fp, Ww^Ewf, Ww, Ww, Wwf^Edb, Wwf^Edt, Wwf^Edb, Gg, Ww, Gs^Fms, Gg^Em, Gg^Em, Gg^Emf, Gg, Gg, Gs, Gs^Fms, Gs^Fds, Gg^Gvs, Gg^Gvs, Gs^Fms, Gll^Fp, Gs^Fms, Ww, Ww, Ww, Gs^Fms, Ww, Wwr, Ww, Wwr, Gg, Ww, Ww, Ww, Wo, Ww, Ww^Ewl
Gs^Fms, Gg, Gs^Em, Gg, Gs, Gs^Fms, Re, Re^Edt, Co, Co, Co, Ww^Ewl, Gs, Gs, Gs^Em, Gd^Vo, Gs^Fms, Gg, Gg^Efm, Gg, Gs, Gg, Gs^Fds, Gs^Vh, Gg^Gvs, Gll^Fp, Gg, Gs^Fms, Gs^Fms, Gg, Gg^Em, Gs^Fms, Gg^Em, Ww, Wwr, Wwr, Ww, Ww, Wo, Ww, Ww^Ewl, Gg
Gg, Gs^Fms, Gd^Vo, Gg^Em, Gs^Fds, Re, Re, Re^Edb, Co, 6 Ko, Co, Rb^Edb, Gd, Gd, Gs, Gs^Em, Gs^Fms, Gg, Gll^Fp, Gg, Gs, Gg, Gs, Gs^Fds, Gg, Gs, Gs, Gs, Gg, Gll^Fp, Gg^Em, Gs^Vc, Gs^Fms, Gg, Ww, Ww, Ww, Ww, Wo, Ww, Ww^Ewf, Gg
Gg, Gg^Emf, Gs^Em, Gg^Em, Gs^Fms, Rb, Rb, Rb^Edt, Gd^Vo, Co, Re^Edb, Rb^Edt, Rb, Rb, Gs, Gg, Gg^Emf, Gg, Gg, Gg, Gg^Efm, Gg, Gs, Gs, Gs, Gs, Gg, Gs^Fms, Gs^Fds, Gg, Gs^Fms, Gs^Emf, Gg, Gg, Ww, Ww, Ww, Ww, Ww, Ww, Ww^Ewl, Gg
Gs^Fms, Gg, Gg, Gg, Rb, Gd, Gd, Rb, Rb, Re^Edt, Rb, Re, Rb, Rb, Gs, Gs^Em, Gd^Vo, Gg^Em, Gs, Gs^Fms, Gg, Gs^Fms, Gg, Gg, Gs^Fms, Gg, Gs^Fms, Gg, Gs, Gs^Fms, Gg, Gg, Ww^Ewf, Ww^Ewl, Ww, Ww, Wo, Wo, Ww, Ww, Gg, Gg
Gg, Gs, Gs, Rb, Rb, Gd, Rb, Rb, Re, Gd, Rb, Rb, Rb, Rb, Rb, Gs^Em, Gg^Em, Gg^Em, Gg, Gg, Gs, Gg, Gg, Gs^Fms, Gg, Gs, Gg, Gg, Gs, Gg, Gg^Efm, Ww^Ewl, Ww, Ww, Ww, Wo, Wo, Wo, Ww, Ww^Ewl, Gg^Efm, Gg^Efm
Gg, Gg, Gs^Fms, Gg, Gg, Rb, Gs^Fms, Gg, Gg, Rb, Re, Rb, Gg, Gg, Gs^Fms, Gg, Gs^Fms, Gs, Gg, Gs, Gg, Gs, Gg, Gs, Gs^Fms, Gg, Gs^Fms, Gg, Gg, Gg, Gg, Ww, Ww, Ww, Ww, Wo, Ww, Ww, Ww, Gg, Gg, Gg^Efm
