Xu, Xu, Xu, Xu, Xu, Xu, Xu, Xu, Xu, Uu, Ql, Xu, Xu, Xu, Xu, Xu, Xu, Xu, Xu, Xu, Xu, Xu, Xu, Xu, Re, Uu, Uh, Xu, Xu, Xu, Xu, Xu, Xu, Xu, Xu, Xu, Xu, Xu, Xu, Xu, Xu, Xu, Xu, Xu, Xu, Xu, Xu, Xu, Xu, Xu
Xu, Xu, Xu, Xu, Xu, Xu, Xu, Xu, Re, Uu, Ql^Bcx\, Xu, Uu, Uu, Uu, Xu, Xu, Xu, Xu, Xu, Xu, Xu, Xu, Xu, Re, Uu, Uu, Uu, Re, Xu, Xu, Xu, Xu, Xu, Xu, Xu, Xu, Xu, Xu, Xu, Xu, Xu, Xu, Xu, Xu, Xu, Xu, Xu, Xu, Xu
Xu, Xu, Xu, Xu, Xu, Xu, Xu, Xu, Uu, Ql, Ql, Re, Xu, Xu, Xu, Uu, Xu, Xu, Xu, Xu, Xu, Xu, Xu, Uu, Xu, Uu, Xu, Re, Re, Xu, Xu, Xu, Xu, Xu, Xu, Xu, Xu, Xu, Xu, Xu, Xu, Xu, Xu, Xu, Xu, Xu, Xu, Xu, Xu, Xu
Xu, Xu, Xu, Xu, Xu, Xu, Xu, Uu, Uu, Ql, Ql, Re, Re, Xu, Xu, Re, Uu, Xu, Xu, Xu, Xu, Xu, Uu, Re, Xu, Xu, Xu, Re, Uu, Xu, Xu, Xu, Xu, Xu, Xu, Xu, Xu, Xu, Xu, Xu, Xu, Xu, Xu, Xu, Xu, Xu, Xu, Xu, Xu, Xu
Xu, Xu, Xu, Xu, Xu, Xu, Xu, Uu, Uu, Uu, Re, Re, Uu, Uu, Xu, Xu, Xu, Uu, Uu, Re, Re, Uu, Xu, Xu, Xu, Xu, Xu, Uu, Uu, Uu, Uu, Xu, Xu, Xu, Xu, Xu, Xu, Xu, Xu, Xu, Xu, Xu, Xu, Xu, Xu, Xu, Xu, Xu, Xu, Xu
Xu, Xu, Xu, Xu, Xu, Xu, Uu, Uu, 5 Uu, Uu, Re, Uu, Re, Re, Xu, Xu, Xu, Xu, Xu, Xu, Ql, Re, Xu, Xu, Xu, Xu, Xu, Xu, Uu, Xu, Uu, Xu, Xu, Xu, Xu, Xu, Xu, Xu, Xu, Xu, Xu, Xu, Xu, Xu, Xu, Xu, Xu, Xu, Xu, Xu
Xu, Xu, Xu, Xu, Xu, Xu, Re, Uu, Uu, Uu, Re, Uu, Uu, Re, Xu, Xu, Xu, Xu, Xu, Ql, Re, Re, Re, Xu, Uh, Xu, Xu, Xu, Xu, Re, Uu, Uu, Uu, Xu, Xu, Xu, Xu, Xu, Xu, Xu, Xu, Xu, Xu, Xu, Xu, Xu, Xu, Xu, Xu, Xu
Xu, Xu, Xu, Xu, Re, Uu, Uu, Re, Uu, Uu, Re, Uu, Re, Re, Uu, Xu, Xu, Xu, Xu, Xu, Re, Xu, Xu, Uu, Xu, Uh, Uu, Xu, Uu, Xu, Re, Xu, Ql, Uu, Xu, Xu, Xu, Xu, Xu, Xu, Xu, Xu, Xu, Xu, Xu, Xu, Xu, Xu, Xu, Xu
Xu, Xu, Xu, Xu, Uu^Vu, Ql, Uu, Re, Uu, Uh, Xu, Uu, Uu, Uu, Uu, Xu, Xu, Xu, Xu, Xu, Re, Xu, Xu, Xu, Xu, Xu, Xu, Uu, Xu, Uu, Uh, Ql, Re, Re, Uu, Xu, Uu, Xu, Xu, Xu, Xu, Xu, Xu, Xu, Xu, Xu, Xu, Xu, Xu, Xu
Xu, Xu, Xu, Xu, Ql, Ql, Uu, Xu, Uh, Xu, Uu, Re, Uu, Uu, Re, Xu, Xu, Xu, Xu, Uu, Xu, Xu, Xu, Xu, Xu, Xu, Xu, Xu, Xu, Xu, Xu, Re, Xu, Re, Re, Uu, Xu, Uu, Re, Xu, Xu, Xu, Xu, Xu, Xu, Xu, Xu, Xu, Xu, Xu
Xu, Xu, Xu, Ql, Ql, Ql, Uu, Xu, Xu, Uu, Uu, Re, Re, Re, Xu, Xu, Xu, Xu, Xu, Uu, Xu, Xu, Xu, Xu, Xu, Xu, Xu, Xu, Xu, Xu, Xu, Re, Xu, Xu, Uu, Xu, Xu, Xu, Uu, Xu, Xu, Xu, Xu, Xu, Xu, Xu, Xu, Xu, Xu, Xu
Xu, Xu, Xu, Xu, Uu^Vu, Ql, Uu, Xu, Xu, Uu, Re, Uh, Xu, Xu, Xu, Xu, Xu, Xu, Uu, Re, Xu, Xu, Xu, Xu, Xu, Xu, Xu, Xu, Xu, Xu, Xu, Uu, Uu, Xu, Xu, Uu, Xu, Xu, Uu, Xu, Xu, Xu, Xos, Xos, Xos, Xu, Xu, Xu, Xu, Xu
Xu, Xu, Xu, Xu, Re, Ql, Uu, Xu, Xu, Uu, Uu, Uu, Xu, Xu, Xu, Xu, Xu, Xu, Re, Xu, Xu, Xu, Xu, Xu, Xu, Xu, Xu, Xu, Xu, Xu, Xu, Xu, Xu, Uu, Uu, Uu, Xu, Xu, Xu, Uu, Uu, Xos, Uu, Uu, Uu, Xos, Xos, Xu, Xu, Xu
Xu, Xu, Xu, Xu, Re, Uu, Uu, Xu, Uu, Uu, Uu^Vud, Re, Xu, Xu, Xu, Xu, Uu, Uu, Xu, Xu, Xu, Xu, Xu, Xu, Xu, Xu, Xu, Xu, Xu, Xu, Xu, Xu, Xu, Xu, Xu, Uu, Uu, Xu, Xu, Xu, Uu, Uu, Urb, Urb, Urb, Uu, Uu, Xos, Xu, Xu
Xu, Xu, Xu, Xu, Re, Uu, Uu, Xu, Re, Re, Uu, Uu, Xu, Xu, Xu, Xu, Xu, Re, Xu, Xu, Xu, Xu, Xu, Xu, Xu, Xu, Xu, Xu, Xu, Xu, Uu, Xu, Uu, Uh, Re, Uu, Uu, Uu, Re, Uu, Uu, Uu^Vud, Ur, Ur, Ur, Urb, Uu, Xos, Xu, Xu
Xu, Xu, Xu, Uu, Uu, Re, Uu, Xu, Uu, Uu, Uu, Uu, Re, Xu, Xu, Xu, Re, Uu, Xu, Xu, Xu, Xu, Xu, Xu, Xu, Xu, Re, Uu, Uu, Uu, Uu, Uu, Re, Re, Ql, Re, Uu, Uu, Re, Re, Uu, Re, Ur, sceptre Urb^Ii, Ur, Urb, Uu, Ql, Xu, Xu
Xu, Xu, Xu, Re, Uu, Uu, Xu, Xu, Uu, Re, Uu, Uu, Xu, Xu, Xu, Uu, Xu, Xu, Re, Xu, Xu, Xu, Xu, Xu, Uh, Uu, Uu, Uu, Re, Re, Uu, Uu, Uu, Ql, Ql, Ql, Ql, Re, Uu, Re, Re, Uu, Ur, Ur, Re, Urb, Uu, Xos, Xu, Xu
Xu, Xu, Xu, Uu, Re, Uu, Xu, Xu, Uu, Re, Uu, Uu, Re, Xu, Re, Re, Uu, Uu, Re, Uu, Re, Xu, Re, Uu, Uu, Uu, Uue, Uu, Re, Uu, Uu, Re, Xu, Xu, Ql, Ql, Ql, Uu, Re, Uu, Ur, Ur, Uh, Uu, Uu, Uu, Xos, Xos, Xu, Xu
Xu, Xu, Xu, Re, Uu, Uu, Xu, Xu, Re, Uu, Uue, Uu, Uu, Uu, Xu, Uu, Uu, Uh, Uu, Uu, Uu, Uu, Re, Re, Re, Uu, Uu^Vud, Uu, Xu, Xu, Xu, Xu, Xu, Ql, Ql, Ql, Ql, Uu, Re, Ur, Uu, Uu, Xos, Uu, Xos, Xos, Xu, Xu, Xu, Xu
Xu, Xu, Xu, Re, Uh, Uu, Xu, Xu, Re, Uu, Uue, Uu^Vud, Re, Uu, Uu, Uu, Uh, Uu, Xu, Re, Re, Uu, Uu, Uu, Xu, Xu, Xu, Xu, Xu, Xu, Xu, Xu, Xu, Xu, Uu^Vu, Ql, Ql, Uu, Uu, Ur, Uu, Uh, Uu, Xos, Xu, Xu, Xu, Xu, Xu, Xu
Xu, Xu, Xu, Uu, Uu, Uu, Xu, Xu, Uu, Uu, Uu, Uu, Uu, Re, Re, Re, Uu, Uu, Xu, Xu, Xu, Uu, Xu, Xu, Xu, Xu, Xu, Xu, Xu, Xu, Xu, Xu, Xos, Xos, Re, Ql, Uu, Re, Re, Ur, Re, Uu, Re, Xu, Xu, Xu, Xu, Xu, Xu, Xu
Xu, Xu, Xu, Re, Uu, Re, Xu, Xu, Re, Uu, Re, Re, Uu, Re, Re, Uu, Xu, Xu, Xu, Xu, Xu, Xu, Xu, Xu, Xu, Xu, Xu, Xu, Xu, Xu, Xu, Xu, Xos, Uu, Uu, Re, Cud, Uu, Ur, Ur, Re, Uu, Uu, Uu, Xu, Xu, Xu, Xu, Xu, Xu
Xu, Xu, Xu, Uu, Re, Uu, Xu, Xu, Xu, Xu, Re, Uu, Re, Re, Re, Xu, Xu, Xu, Xu, Xu, Xu, Xu, Xu, Xu, Xu, Xu, Xu, Xu, Xu, Xu, Xu, Xu, Xos, Uu, Re, Cud, 6 Kud, Cud, Uu, Re, Uu, Re, Uu, Uu, Xu, Xu, Xu, Xu, Xu, Xu
Xu, Xu, Uu, Uu, Re, Uu, Xu, Xu, Xu, Uu, Xu, Uu, Uu, Uu, Re, Re, Uu, Xu, Xu, Xu, Xu, Xu, Xu, Xu, Xu, Xu, Xu, Xu, Xu, Xu, Xu, Xu, Xos, Uu, Uu, Cud, Cud, Cud, Re, Re, Uu, Uu, Uu, Re, Xu, Xu, Xu, Xu, Xu, Xu
Xu, Xu, Uu, Uu, Re, Re, Xu, Xu, Xu, Re, Xu, Uu, Xu, Xu, Uu, Xu, Re, Re, Xu, Xu, Xu, Xu, Xu, Xu, Xu, Xu, Xu, Xu, Xu, Xu, Xu, Xu, Xos, Re, Re, Re, Uu, Uu, Uu, Uu, Uu, Re, Uu, Uu, Xu, Xu, Xu, Xu, Xu, Xu
Xu, Xu, Uu, Re, Re, Xu, Xu, Xu, Xu, Uu, Uu, Re, Xu, Xu, Uu, Xu, Uu, Xu, Xu, Xu, Xu, Xu, Xu, Xu, Xu, Xu, Xu, Xu, Xu, Xu, Xu, Xu, Xos, Re, Uu, Uu, Re, Uu, Re, Uu, Uu, Re, Uu, Uu, Uu, Xu, Xu, Xu, Xu, Xu
Xu, Xu, Uu, Uu, Uu, Xu, Xu, Xu, Xu, Uu, Re, Xu, Xu, Xu, Re, Xu, Re, Xu, Xu, Xu, Xu, Xu, Xu, Xu, Xu, Xu, Xu, Xu, Xu, Xu, Xu, Xu, Xu, Xos, Uu, Uu^Vud, Uu, Re, Re, Re, Uu^Vud, Uu, Uue, Uu, Xu, Re, Xu, Xu, Xu, Xu
Xu, Xu, Uu, Uh, Uu, Re, Xu, Xu, Xu, Xu, Re, Xu, Xu, Xu, Xu, Uh, Xu, Re, Xu, Xu, Xu, Xu, Xu, Xu, Xu, Xu, Xu, Xu, Xu, Xu, Xu, Xu, Re, Uu, Xu, Xos, Uu, Re, Re, Re, Uu, Uu, Uu, Uu, Uu, Re, Xu, Xu, Xu, Xu
Xu, Xu, Xu, Uu, Re, Re, Xu, Xu, Xu, Xu, Uu, Xu, Xu, Xu, Xu, Re, Uu, Uu, Xu, Xu, Xu, Xu, Xu, Xu, Xu, Xu, Xu, Xu, Xu, Xu, Xu, Xu, Re, Xu, Xu, Uu, Uu, Uu, Uu, Re, Uu, Re, Re, Uu, Xu, Xu, Xu, Xu, Xu, Xu
Xu, Xu, Uu, Uu, Re, Uu, Xu, Xu, Xu, Xu, Uu, Xu, Xu, Xu, Xu, Xu, Uu, Uu, Re, Xu, Xu, Xu, Xu, Xu, Xu, Xu, Xu, Xu, Xu, Xu, Re, Uu, Xu, Xu, Uu, Uu, Re, Uu, Uu, Re, Re, Uu, Xu, Uu, Xu, Xu, Xu, Xu, Xu, Xu
Xu, Xu, Re, Uu, Uu, Uu, Xu, Xu, Xu, Xu, Uu, Uu, Uu, Xu, Xu, Xu, Uu, Xu, Uu, Xu, Xu, Xu, Xu, Xu, Xu, Xu, Xu, Xu, Xu, Xu, Uu, Xu, Xu, Xu, Uu, Uu, Uu, Uu, Uu, Uu, Uu, Xu, Xu, Re, Uu, Xu, Xu, Xu, Xu, Xu
Xu, Xu, Xu, Uu, Uu, Uu, Xu, Xu, Xu, Xu, Uu, Xu, Re, Re, Uu, Xu, Xu, Uu, Xu, Re, Re, Xu, Xu, Xu, Xu, Xu, Xu, Xu, Xu, Xu, Uu, Xu, Xu, Xu, Uu, Re, Re, Re, Re, Uu, Xu, Xu, Xu, Xu, Xu, Uu, Xu, Xu, Xu, Xu
Xu, Xu, Xu, Uu, Uh, Re, Xu, Xu, Xu, Xu, Uu, Xu, Xu, Xu, Re, Xu, Xu, Re, Xu, Xu, Xu, Uu, Re, Xu, Xu, Xu, Xu, Xu, Uu, Xu, Re, Xu, Re, Re, Xu, Uu, Uu, Uu, Ql, Uu^Vu, Xu, Xu, Xu, Xu, Xu, Re, Xu, Xu, Xu, Xu
Xu, Xu, Xu, Uu, Uu, Uu, Xu, Xu, Xu, Uh, Xu, Xu, Xu, Xu, Xu, Uu^Vud, Re, Re, Uu, Xu, Xu, Xu, Xu, Uu, Uu, Xu, Uu, Uu, Xu, Uu, Re, Uu, Xu, Xu, Xu, Uu, Uu^Vud, Uu, Ql, Ql, Ql, Ql, Xu, Xu, Xu, Uu, Xu, Xu, Xu, Xu
Xu, Xu, Xu, Re, Re, Re, Uu, Xu, Xu, Uu, Xu, Xu, Xu, Xu, Uu, Re, Re, Uu, Re, Xu, Xu, Xu, Xu, Xu, Xu, Uu, Uu, Xu, Xu, Uu, Xu, Xu, Xu, Xu, Xu, Re, Re, Uu, Ql, Ql, Ql, Ql, Uu^Vu, Xu, Xu, Re, Uu, Xu, Xu, Xu
Xu, Xu, Xu, Re, Uu, Uu, Uu, Xu, Xu, Re, Uh, Xu, Xu, Xu, Uh, Uu, Re, Uu, Re, Uu, Re, Uu, Re, Xu, Xu, Uu, Uh, Uu, Uu, Uu, Uu, Re, Re, Xu, Xu, Re, Uu, Uu, Re, Ql, Ql, Ql, Ql, Uu, Xu, Xu, Uu, Xu, Xu, Xu
Xu, Xu, Xu, Xu, Uu, Uue, Uue, Uu, Xu, Xu, Xu, Uu, Uu, Re, Re, Re, Uu, Uu, Uu, Uu^Vud, Xu, Xu, Xu, Uu, Re, Re, Re, Re, Xu, Uu, Uu, Xu, Xu, Uu, Uh, Uu, Re, Uu, Uu, Uu, Uu, Ql, Re, Uu, Xu, Xu, Uu, Xu, Xu, Xu
Xu, Xu, Xu, Xu, Xu, Uu, Uu, Uu, Re, Xu, Xu, Uu, Re, Uu, Re, Uu, Uu, Re, Uu, Xu, Xu, Xu, Xu, Xu, Uu, Uu, Xu, Xu, Xu, Xu, Uu, Xu, Xu, Xu, Re, Re, Uu, Re, Re, Uu, Uue, Uu, Uu, Uu, Re, Xu, Xu, Re, Xu, Xu
Xu, Xu, Xu, Xu, Xu, Re, Re, Re, Uu, Xu, Xu, Uu, Xu, Uu, Re, Uu, Uu, Uu, Xu, Xu, Xu, Xu, Re, Re, Xu, Xu, Xu, Xu, Xu, Xu, Uu, Xu, Xu, Xu, Uu, Uh, Uu, Uu, Uu, Uu, Uu, Uu, Uu, Uu, Re, Xu, Xu, Re, Xu, Xu
Xu, Xu, Xu, Xu, Uu, Re, Uu, Uu, Re, Xu, Xu, Uu, Xu, Uu, Uu, Re, Uu, Re, Xu, Xu, Xu, Xu, Re, Uu, Xu, Xu, Xu, Xu, Xu, Xu, Xu, Re, Xu, Xu, Uu, Re, Uu, Uue, Uu, Re, Xu, Xu, Re, Re, Uu, Uu, Xu, Uu, Xu, Xu
Xu, Xu, Uu, Uu, Ql, Ql, Uu, Uu, Xu, Xu, Xu, Uu, Re, Uu, Uu, Uu^Vud, Uu, Xu, Xu, Xu, Uu, Xu, Uu, Uu, Xu, Xu, Xu, Xu, Xu, Xu, Uu, Uu^Vud, Xu, Xu, Xu, Uu, Uue, Uu, Re, Uu, Xu, Xu, Xu, Re, Uu, Uh, Uu, Uu, Xu, Xu
Xu, Re, Ql, Ql, Ql, Uu^Vu, Xu, Xu, Xu, Xu, Uu, Re, Re, Re, Re, Re, Xu, Xu, Xu, Uu, Xu, Uu, Xu, Xu, Xu, Xu, Xu, Xu, Xu, Xu, Uu, Xu, Xu, Xu, Xu, Uu, Uue, Uu, Re, Uu, Re, Xu, Xu, Re, Re, Uu, Re, Xu, Xu, Xu
Xu, Uu, Ql, Ql, Ql, Xu, Xu, Xu, Xu, Uu, Xu, Re, Uu, Uu, Uu, Uu, Xu, Xu, Xu, Uu, Xu, Xu, Xu, Xu, Xu, Xu, Xu, Xu, Xu, Xu, Xu, Uu, Uu, Xu, Xu, Uu, Uu, Uu, Re, Uu^Vud, Uu, Xu, Uu, Re, Uu, Uu, Uu, Xu, Xu, Xu
Xu, Uu, Ur, Ql, Uu^Vu, Xu, Xu, Xu, Uu, Uu, Xu, Re, Re, Uu, Uu, Uu, Xu, Xu, Uu, Re, Xu, Xu, Xu, Xu, Xu, Xu, Xu, Xu, Xu, Xu, Xu, Xu, Uu, Xu, Xu, Re, Uu, Uu, Uu, Uu, Re, Xu, Re, Re, Re, Uh, Re, Xu, Xu, Xu
Xu, Re, Uu, Ql^Bcx\, Uu, Xu, Xu, Xu, Xu, Uu, Re, Re, Uu, Re, Ql, Uu, Uu, Re, Xu, Xu, Xu, Xu, Xu, Xu, Xu, Xu, Xu, Xu, Xu, Xu, Xu, Uh, Xu, Xu, Xu, Uu, Uu, Uu, Re, Uu, Re, Uu, Uu, Re, Uu, Xu, Uu, Xu, Xu, Xu
Xu, Xu, Re, Ql, Uu, Xu, Xu, Xu, Uu, Uu, Uu, Uu, Re, Ql, Ql, Ql, Uu^Vu, Xu, Xu, Xu, Xu, Xu, Xu, Xu, Xu, Xu, Xu, Xu, Xu, Xu, Xu, Re, Re, Xu, Xu, Re, Uu, Uu, Uu, Re, Uu, Uu, Re, Uu, Re, Xu, Uu, Xu, Xu, Xu
Xu, Xu, Re, Uu, Uue, Uu, Xu, Uu, Re, Re, Re, Uh, Uu, Ql, Ql, Ql, Ql, Xu, Xu, Xu, Xu, Xu, Xu, Xu, Xu, Xu, Xu, Xu, Xu, Xu, Xu, Xu, Xu, Re, Re, Re, Re, Uu, Re, Uu, Uue, Uu, Uu, Re, Uu, Xu, Uu, Uu, Xu, Xu
Xu, Xu, Xu, Uu, Uu, Uu, Uu, Uu, Uu, Uu, Re, Re, Uu, Ql, Uu^Vu, Xu, Xu, Xu, Xu, Xu, Xu, Xu, Xu, Xu, Xu, Xu, Xu, Xu, Xu, Xu, Xu, Xu, Xu, Re, Re, Uu, Uu, Uu, Uu, Uu, Uu, Uu, Uu, Uh, Uu, Xu, Uu, Xu, Xu, Xu
Xu, Xu, Xu, Uu, Re, Uu, Uu, Re, Re, Uu, Uu, Uu, Re, Uu, Uu, Xu, Xu, Xu, Xu, Xu, Xu, Xu, Xu, Xu, Xu, Xu, Xu, Xu, Xu, Xu, Xu, Xu, Re, Uu, Uu, Uu, Uue, Uue, Uu, Uu, Re, Re, Re, Uu, Uu, Re, Uu^Vud, Xu, Xu, Xu
Xu, Xu, Xu, Xu, Xu, Re, Uu, Uu, Uu, Uu, Re, Re, Uu, Re, Uu, Xu, Xu, Xu, Xu, Xu, Xu, Xu, Xu, Xu, Xu, Xu, Xu, Xu, Xu, Xu, Xu, Xu, Re, Uu, Uue, Uue, Uue, Uue, Uu, Xu, Xu, Uu, Uu, Re, Uu, Uu, Uh, Xu, Xu, Xu
Xu, Xu, Xu, Xu, Uu, Uu, Uu, Re, Re, Uu, Uu, Uu, Uu, Re, Uu, Re, Xu, Xu, Xu, Xu, Xu, Xu, Xu, Xu, Xu, Xu, Xu, Xu, Xu, Xu, Xu, Uu, Uu, Uu, 3 Uue, Uue, Uu, Uu, Re, Xu, Xu, Xu, Xu, Re, Uu^Vud, Uu, Uu, Uu, Xu, Xu
Xu, Xu, Xu, Xu, Uu, Re, Uu, Re, Ql, Ql, Ql, Uh, Re, Uu, Uue, Uu, Re, Xu, Xu, Xu, Xu, Xu, Xu, Xu, Xu, Xu, Xu, Xu, Xu, Xu, Xu, Re, Ql, Uu, Uu, Uu, Uu, Re, Uu, Uu, Re, Re, Re, Xu, Re, Uu, Uu, Xu, Xu, Xu
Xu, Xu, Xu, Xu, Xos, Uu, Cud, Cud, Cud, Ql, Ql, Ql, Ql, Uu, Uu, Uu, Re, Uu, Xu, Xu, Xu, Xu, Xu, Xu, Xu, Xu, Xu, Xu, Xu, Xu, Xu, Uu, Ql, Ql, Ql, Re, Uu, Uu, Uue, Uu, Uu, Xu, Xu, Uu, Uu, Re, Uu, Uu, Xu, Xu
Xu, Xu, Xu, Xu, Xos, Uu, Cud, 4 Kud, Cud, Ql, Ql, Ql, Ql, Uu, Re, Uu, Uu, Uh, Re, Xu, Xu, Xu, Xu, Xu, Xu, Xu, Xu, Xu, Xu, Xu, Xu, Uu^Vu, Ql, Ql, Ql, Ql, Uu, Uue, Uu, Uu, Uu^Vud, Xu, Xu, Uu, Re, Uu, Re, Re, Uu, Xu
Xu, Xu, Xu, Xu, Xu, Xos, Xos, Cud, Xos, Ql, Uu^Vu, Ql, Uu, Uu, Cud, Re, Uu, Re, Re, Xu, Xu, Xu, Xu, Xu, Xu, Xu, Xu, Xu, Xu, Xu, Xu, Xu, Ql, Ql, Ql, Ql, Uu, Uu, Re, Uu, Xu, Xu, Xu, Uu, Uu, Uu, Uu^Uf, Re, Uu, Re
Xu, Xu, Xu, Xu, Xu, Xu, Xu, Xos, Xu, Xu, Xu, Uu, Xos, Cud, 2 Kud, Cud, Uu, Re, Re, Re, Xu, Xu, Xu, Xu, Xu, Xu, Xu, Xu, Xu, Xu, Xu, Xu, Xu, Uu^Vud, Ql, Ql, Uu^Uf, Uu, Re, Uu, Xu, Xu, Xu, Xu, Uu, Re, Uu, Re, Uu^Vud, Uu
Xu, Xu, Xu, Xu, Xu, Xu, Xu, Xu, Xu, Xu, Xu, Xu, Xos, Cud, Cud, Cud, Re, Re, Uu^Uf, Uu, Xu, Xu, Xu, Xu, Xu, Xu, Xu, Xu, Xu, Xu, Xu, Xu, Xu, Uu, Re, Uu, Uu, Xu, Xu, Xu, Xu, Xu, Xu, Xu, Uu, Uu^Vud, Cud, Cud, Cud, Xos
Xu, Xu, Xu, Xu, Xu, Xu, Xu, Xu, Xu, Xu, Xu, Xu, Xu, Xos, Xos, Uu, Uu, Uu, Re, Xu, Xu, Xu, Xu, Xu, Xu, Xu, Xu, Xu, Xu, Xu, Xu, Xu, Xu, Xu, Uu, Uu, Uu, Re, Xu, Xu, Xu, Xu, Xu, Xu, Xos, Re, Cud, 7 Kud, Cud, Xos
Xu, Xu, Xu, Xu, Xu, Xu, Xu, Xu, Xu, Xu, Xu, Xu, Xu, Xu, Xu, Re, Uu^Vud, Uu, Uu, Uu, Uu, Uu^Vud, Uu, Xu, Xu, Xu, Xu, Xu, Xu, Xu, Xu, Xu, Xu, Xu, Uu^Vud, Uu, Uue, Uu, Xu, Xu, Xu, Xu, Xu, Xu, Xos, Uu, Uu^Uf, Cud, Xos, Xos
Xu, Xu, Xu, Xu, Xu, Xu, Xu, Xu, Xu, Xu, Xu, Xu, Xu, Xu, Xu, Xu, Xu, Uu, Uu, Uu, Re, Uu, Uu, Re, Uu^Vud, Xu, Xu, Xu, Xu, Xu, Xu, Xu, Xu, Xu, Uu, Uu, Uu, Uu, Xu, Xu, Xu, Xu, Xu, Xu, Xu, Xos, Xos, Xos, Xu, Xu
Xu, Xu, Xu, Xu, Xu, Xu, Xu, Xu, Xu, Xu, Xu, Xu, Xu, Xu, Xu, Xu, Xu, Xu, Xu, Uu, Uu, Re, Uu, Uu, Uu, Xu, Xu, Xu, Xu, Xu, Xu, Xu, Xu, Uu, Uue, Uu, Re, Xu, Xu, Xu, Xu, Xu, Xu, Xu, Xu, Xu, Xu, Xu, Xu, Xu
Xu, Xu, Xu, Xu, Xu, Xu, Xu, Xu, Xu, Xu, Xu, Xu, Xu, Xu, Xu, Xu, Xu, Xu, Xu, Xu, Xu, Xu, Uu^Vud, Re, Uu^Uf, Re, Uu, Xu, Re, Xu, Xu, Uu, Uu, Uu^Vud, Uu, Uu, Xu, Xu, Xu, Xu, Xu, Xu, Xu, Xu, Xu, Xu, Xu, Xu, Xu, Xu
Xu, Xu, Xu, Xu, Xu, Xu, Xu, Xu, Xu, Xu, Xu, Xu, Xu, Xu, Xu, Xu, Xu, Xu, Xu, Xu, Xu, Xu, Xu, Uu, Uu, Uu^Uf, Uu, Uu, Uu, Uu, Re, Uu^Uf, Uu, Uu, Re, Uu, Xu, Xu, Xu, Xu, Xu, Xu, Xu, Xu, Xu, Xu, Xu, Xu, Xu, Xu
Xu, Xu, Xu, Xu, Xu, Xu, Xu, Xu, Xu, Xu, Xu, Xu, Xu, Xu, Xu, Xu, Xu, Xu, Xu, Xu, Xu, Xu, Xu, Xu, Xu, Re, Uu^Uf, Uu, Uu, Uu, Uu^Uf, Uu, Cud, Cud, Cud, Xu, Xu, Xu, Xu, Xu, Xu, Xu, Xu, Xu, Xu, Xu, Xu, Xu, Xu, Xu
Xu, Xu, Xu, Xu, Xu, Xu, Xu, Xu, Xu, Xu, Xu, Xu, Xu, Xu, Xu, Xu, Xu, Xu, Xu, Xu, Xu, Xu, Xu, Xu, Xu, Xu, Uu, Uu^Uf, Uu, Re, Re, Re, Cud, 1 Kud, Cud, Uu, Xu, Xu, Xu, Xu, Xu, Xu, Xu, Xu, Xu, Xu, Xu, Xu, Xu, Xu
Xu, Xu, Xu, Xu, Xu, Xu, Xu, Xu, Xu, Xu, Xu, Xu, Xu, Xu, Xu, Xu, Xu, Xu, Xu, Xu, Xu, Xu, Xu, Xu, Xu, Xu, Uu, Uu, Uue, Uu, Uu, Re, Uu, Cud, Uu, Re, Xu, Xu, Xu, Xu, Xu, Xu, Xu, Xu, Xu, Xu, Xu, Xu, Xu, Xu
Xu, Xu, Xu, Xu, Xu, Xu, Xu, Xu, Xu, Xu, Xu, Xu, Xu, Xu, Xu, Xu, Xu, Xu, Xu, Xu, Xu, Xu, Xu, Xu, Xu, Xu, Uu, Uu, Uu, Uu, Uu, Uu, Xu, Uu^Vud, Xu, Xu, Xu, Xu, Xu, Xu, Xu, Xu, Xu, Xu, Xu, Xu, Xu, Xu, Xu, Xu
Xu, Xu, Xu, Xu, Xu, Xu, Xu, Xu, Xu, Xu, Xu, Xu, Xu, Xu, Xu, Xu, Xu, Xu, Xu, Xu, Xu, Xu, Xu, Xu, Xu, Xu, Uu, Re, Uu, Re, Uu, Uu, Uu, Xu, Xu, Xu, Xu, Xu, Xu, Xu, Xu, Xu, Xu, Xu, Xu, Xu, Xu, Xu, Xu, Xu
Xu, Xu, Xu, Xu, Xu, Xu, Xu, Xu, Xu, Xu, Xu, Xu, Xu, Xu, Xu, Xu, Xu, Xu, Xu, Xu, Xu, Xu, Xu, Xu, Xu, Uu, Uu, Uu, Uu, Uu, Uu, Uue, Uu, Re, Xu, Xu, Xu, Xu, Xu, Xu, Xu, Xu, Xu, Xu, Xu, Xu, Xu, Xu, Xu, Xu
Xu, Xu, Xu, Xu, Xu, Xu, Xu, Xu, Xu, Xu, Xu, Xu, Xu, Xu, Xu, Xu, Xu, Xu, Xu, Xu, Xu, Xu, Xu, Xu, Xu, Uu, Uu, Xu, Re, Uu^Uf, Uh, Uu, Uu, Xu, Xu, Xu, Xu, Xu, Xu, Xu, Xu, Xu, Xu, Xu, Xu, Xu, Xu, Xu, Xu, Xu
