border_size=1
usage=map

Xu          , Xu          , Xu          , Xu          , Xu          , Xu          , Xu          , Xu          , Xu          , Xu          , Xu          , Xu          , Xu          , Xu          , Xu          , Xu          , Xu          , Xu          , Xu          , Xu          , Uu          , Ur          , Ur          , Uu          , Xu          , Xu          , Xu          , Xu          , Xu          , Xu          , Xu          , Xu          , Xu          , Xu          , Xu          , Xu          , Xu          , Xu          , Xu          , Xu          , Xu          , Xu          , Xu          , Xu
Xu          , Xu          , Xu          , Xu          , Xu          , Xu          , Xu          , Xu          , Xu          , Xu          , Xu          , Xu          , Xu          , Xu          , Xos         , Xu          , Xu          , Xu          , Xu          , Xu          , Uu^Uf       , Ur          , Ur          , Uh          , Xu          , Xu          , Xu          , Xu          , Xos         , Xu          , Xu          , Xu          , Xu          , Xu          , Xu          , Xu          , Xu          , Xu          , Xu          , Xu          , Xu          , Xu          , Xu          , Xu
Xu          , Xu          , Xu          , Xu          , Xu          , Xu          , Xu          , Xu          , Xu          , Xu          , Xu          , Xu          , Xos         , Xos         , Iwr         , Xos         , Xos         , Xu          , Xu          , Uh          , Ur          , Ur          , Ur          , Uu          , Xu          , Xu          , Xos         , Xos         , Re          , Xos         , Xos         , Xu          , Xu          , Xu          , Xu          , Xu          , Xu          , Xu          , Xu          , Xu          , Xu          , Xu          , Xu          , Xu
Xu          , Xu          , Xu          , Xu          , Xu          , Xu          , Xu          , Xu          , Xu          , Xu          , Xos         , Xos         , Iwr         , Iwr         , Iwr         , Iwr         , Iwr         , Xos         , Xos         , egDC        , Rr          , Rr          , Rr          , egDC        , Xos         , Xos         , Re^Gvs      , Re          , Re          , Re^Gvs      , Re          , Xos         , Xos         , Xu          , Xu          , Xu          , Xu          , Xu          , Xu          , Xu          , Xu          , Xu          , Xu          , Xu
Xu          , Xu          , Xu          , Xu          , Xu          , Xu          , Xu          , Xu          , Xos         , Xos         , Iwr         , Iwr         , Iwr         , Iwr         , Iwr         , Iwr         , Iwr         , Iwr         , Xos         , Xos         , Rr          , Rr          , Rr          , Xos         , Xos         , Re^Gvs      , Re          , Gs^Fdw      , Re^Gvs      , Re^Gvs      , Gs^Fdw      , Re^Gvs      , Re^Gvs      , Xos         , Xos         , Xu          , Xu          , Xu          , Xu          , Xu          , Xu          , Xu          , Xu          , Xu
Xu          , Xu          , Xu          , Xu          , Xu          , Xu          , Xu          , Xos         , Iwr         , Iwr         , Iwr         , Iwr         , Iwr         , Iwr         , Iwr         , Iwr         , Xos         , Xos         , Uu          , egDC        , Rr          , Rr          , Rr          , egDC        , Uu          , Xos         , Xos         , Re^Gvs      , Re^Gvs      , Re^Gvs      , Re          , Re^Gvs      , Gs^Fdw      , Re^Gvs      , Re          , Xos         , Xu          , Xu          , Xu          , Xu          , Xu          , Xu          , Xu          , Xu
Xu          , Xu          , Xu          , Xu          , Xu          , Xu          , Xu          , Xos         , Xos         , Iwr         , Iwr         , Iwr         , Iwr         , Iwr         , Rr          , Xos         , Uu          , Uu^Vud      , Uu          , Uu          , Rr          , Rr          , Rr          , Uu          , Uu          , Uu^Vud      , Uu          , Xos         , Rr          , Re          , Re          , Re^Gvs      , Re^Gvs      , Re          , Xos         , Xos         , Xu          , Xu          , Xu          , Xu          , Xu          , Xu          , Xu          , Xu
Xu          , Xu          , Xu          , Xu          , Xu          , Xu          , Xu          , Xu          , Xu          , Xos         , Xos         , Iwr         , Xos         , Rr          , Rr          , Rr          , Rr          , Uu          , Uu          , Uu          , Rr          , Rr          , Rr          , Uu          , Uu          , Uu          , Rr          , Rr          , Rr          , Rr          , Xos         , Re          , Xos         , Xos         , Xu          , Xu          , Xu          , Xu          , Xu          , Xu          , Xu          , Xu          , Xu          , Xu
Xu          , Xu          , Xu          , Xu          , Xu          , Xu          , Xu          , Xu          , Xu          , Xu          , Xu          , Xos         , Uu^Vud      , Uu          , Uu          , Rr          , Rr          , Rr          , Rr          , Rr          , Rr          , Rr          , Rr          , Rr          , Rr          , Rr          , Rr          , Rr          , Uu          , Uu          , Uu^Vud      , Xos         , Xu          , Xu          , Xu          , Xu          , Xu          , Xu          , Xu          , Xu          , Xu          , Xu          , Xu          , Xu
Ur          , Uh          , Uu^Uf       , Xu          , Xu          , Xu          , Uu^Uf       , Xu          , Xu          , Xu          , Xu          , Xos         , Uu          , Uu          , Uu          , Uu          , Rr          , Rr          , Rr          , Xos         , Rr          , Rr^Vhc      , Rr          , Xos         , Rr          , Rr          , Rr          , Uu          , Uu          , Uu          , Uu          , Xos         , Xu          , Xu          , Xu          , Xu          , Xu          , Xu          , Xu          , Xu          , Uh          , Xu          , Xu          , Xu
Ur          , Ur          , Ur          , Xu          , Xu          , Xu          , Uh          , Uu          , egDC        , Xu          , Xos         , Xos         , Uu          , Uu          , Rr          , Rr          , Rr          , Rr          , egDC        , Rr          , Ww          , Ww          , Ww          , Rr          , egDC        , Rr          , Rr          , Rr          , Rr          , Uu          , Uu          , Xos         , Xos         , Xu          , egDC        , Xu          , Xu          , Xu          , Uu          , Uh          , Ur          , Uu^Uf       , Ur          , Xu
Uu          , Ur          , Ur          , Uh          , Uu          , Uu          , Ur          , Uu          , Rr          , Xos         , Rr          , egDC        , Rr          , Rr          , Rr          , Rr          , Xos         , Rr          , Wwf         , Ww          , egDC        , Wo          , egDC        , Ww          , Wwf         , Rr          , Xos         , Rr          , Rr          , Rr          , Rr          , egDC        , Rr          , Xos         , Rr          , Uu          , Ur          , Ur          , Ur          , Ur          , Ur          , Ur          , Ur          , Ur
Xu          , Ur          , Ur          , Ur          , Ur          , Ur          , Ur          , Ur          , Rr          , Rr          , Rr          , Rr          , Rr          , Rr          , Rr          , Rr          , Rr          , egDC        , Ww          , Wwf         , egDC        , egDC        , egDC        , Wwf         , Ww          , egDC        , Rr          , Rr          , Rr          , Rr          , Rr          , Rr          , Rr          , Rr          , Rr          , Ur          , Ur          , Ur          , Ur          , Ur          , Uu          , Ur          , Uh          , Ur
Xu          , Xu          , Xu          , Ur          , Ur          , Ur          , Uh          , Ur          , Rr          , Rr          , Rr          , Rr          , Rr          , Rr          , Rr          , Rr          , Rr          , Rr          , Ww          , egDC        , egDC        , 1 egDK      , egDC        , egDC        , Ww          , Rr          , Rr          , Rr          , Rr          , Rr          , Rr          , Rr          , Rr          , Rr          , Rr          , Ur          , Uu^Uf       , Uh          , Xu          , Xu          , Xu          , Xu          , Xu          , Uu^Uf
Xu          , Xu          , Xu          , Ur          , Uu          , Uh          , Xu          , Uu          , egDC        , Xos         , Xos         , egDC        , Uu          , Rr          , Rr          , Rr          , Xos         , Rr          , Ww          , Wo          , egDC        , egDC        , egDC        , Wo          , Ww          , Rr          , Xos         , Rr          , Rr          , Rr          , Uu          , egDC        , Xos         , Xos         , egDC        , Uh          , Xu          , Xu          , Xu          , Xu          , Xu          , Xu          , Xu          , Xu
Xu          , Xu          , Xu          , Ur          , Uu^Uf       , Xu          , Xu          , Xu          , Xu          , Xu          , Xu          , Xos         , Uu          , Uu          , Rr          , Rr          , Rr          , Rr^Vhc      , Rr          , Ww          , Ww          , Wwf         , Ww          , Ww          , Rr          , Rr^Vhc      , Rr          , Rr          , Rr          , Uu          , Uu          , Xos         , Xu          , Xu          , Xu          , Xu          , Xu          , Xu          , Xu          , Xu          , Xu          , Xu          , Xu          , Xu
Xu          , Xu          , Ur          , Uu          , Xu          , Xu          , Xu          , Xu          , Xu          , Xu          , Xu          , Xos         , Uu^Vud      , Uu          , Uu          , Rr          , Rr          , Rr          , Rr          , Rr          , Rr^Vhc      , Wwf         , Rr^Vhc      , Rr          , Rr          , Rr          , Rr          , Rr          , Uu          , Uu          , Uu^Vud      , Xos         , Xu          , Xu          , Xu          , Xu          , Xu          , Xu          , Xu          , Xu          , Xu          , Xu          , Xu          , Xu
Ur          , Ur          , Uu^Uf       , Xu          , Xu          , Xu          , Xu          , Xu          , Xu          , Xu          , Xos         , Xos         , Xos         , Uu          , Uu          , Uu          , Uu          , Rr          , Rr          , Xos         , Rr          , Rr          , Rr          , Xos         , Rr          , Rr          , Rr          , Rr          , Rr          , Uu          , Xos         , Xos         , Xos         , Xu          , Xu          , Xu          , Xu          , Xu          , Xu          , Xu          , Xu          , Xu          , Xu          , Xu
Xu          , Uh          , Xu          , Xu          , Xu          , Xu          , Xu          , Xu          , Xos         , Xos         , Uu^Uf       , Uu^Emf      , Uu^Uf       , Xos         , Xos         , Uu          , Rr          , Rr          , Rr          , Rr          , Rr          , Rr          , Rr          , Rr          , Rr          , Rr          , Uu          , Uu          , Xos         , Rr          , Urb         , Urb         , Urb         , Xos         , Xos         , Xu          , Xu          , Xu          , Xu          , Xu          , Xu          , Xu          , Xu          , Xu
Xu          , Xu          , Xu          , Xu          , Xu          , Xu          , Xos         , Xos         , Uu^Emf      , Uu^Emf      , Uu^Emf      , Uu^Emf      , Uu^Emf      , Uu^Uf       , Uu^Uf       , Rr          , Xos         , Uu          , Uu^Vud      , Rr          , Rr          , Rr          , Rr          , Rr          , Rr          , Uu^Vud      , Xos         , Xos         , Urb         , Urb         , Urb         , Urb         , Urb         , Urb         , Urb         , Xos         , Xos         , Xu          , Xu          , Xu          , Xu          , Xu          , Xu          , Xu
Xu          , Xu          , Xu          , Xu          , Xu          , Xu          , Xu          , Xos         , Xos         , Uu^Uf       , Uu^Uf       , Uu^Uf       , Uu^Uf       , Uu^Uf       , Uu^Uf       , Uu^Emf      , Uu^Uf       , Xos         , Xos         , egDC        , Rr          , Rr          , Rr          , egDC        , Xos         , Rr          , Iwr         , Xos         , Xos         , Urb         , Urb         , Urb         , Urb         , Urb         , Xos         , Xos         , Xu          , Xu          , Xu          , Xu          , Xu          , Xu          , Xu          , Xu
Xu          , Xu          , Xu          , Xu          , Xu          , Xu          , Xu          , Xu          , Xu          , Xos         , Xos         , Uu^Emf      , Uu^Uf       , Uu^Uf       , Uu^Emf      , Uu^Uf       , Uu^Emf      , Uu^Uf       , Uu^Emf      , Xos         , Rr          , Rr          , Rr          , Xos         , Iwr         , Iwr         , Iwr         , Iwr         , Iwr         , Xos         , Xos         , Urb         , Xos         , Xos         , Xu          , Xu          , Xu          , Xu          , Xu          , Xu          , Xu          , Xu          , Xu          , Xu
Xu          , Xu          , Xu          , Xu          , Xu          , Xu          , Xu          , Xu          , Xu          , Xu          , Xu          , Xos         , Xos         , Uu^Uf       , Uu^Emf      , Uu^Uf       , Uu^Uf       , Uu^Uf       , Uu^Uf       , Xos         , Rr          , Rr          , Rr          , Xos         , Iwr         , Iwr         , Iwr         , Iwr         , Iwr         , Iwr         , Xos         , Xos         , Xu          , Xu          , Xu          , Xu          , Xu          , Xu          , Xu          , Xu          , Xu          , Xu          , Xu          , Xu
Xu          , Xu          , Xu          , Xu          , Xu          , Xu          , Xu          , Xu          , Xu          , Xu          , Xu          , Xu          , Xu          , Xos         , Xos         , Uu^Uf       , Uu^Emf      , Uu^Uf       , Xos         , Xos         , Rr          , Rr          , Rr          , Xos         , Xos         , Iwr         , Iwr         , Iwr         , Xos         , Xos         , Xu          , Xu          , Xu          , Xu          , Xu          , Xu          , Xu          , Xu          , Xu          , Xu          , Xu          , Xu          , Xu          , Xu
Xu          , Xu          , Xu          , Xu          , Xu          , Xu          , Xu          , Xu          , Xu          , Xu          , Xu          , Xu          , Xu          , Xu          , Xu          , Xos         , Xos         , Xos         , Xu          , egDC        , Ur          , Rr          , Ur          , egDC        , Xu          , Xos         , Xos         , Xos         , Xu          , Xu          , Xu          , Xu          , Xu          , Xu          , Xu          , Xu          , Xu          , Xu          , Xu          , Xu          , Xu          , Xu          , Xu          , Xu
Xu          , Xu          , Xu          , Xu          , Xu          , Xu          , Xu          , Xu          , Xu          , Xu          , Xu          , Xu          , Xu          , Xu          , Xu          , Xu          , Xu          , Xu          , Uu          , Uu          , Ur          , Ur          , Uu          , Uh          , Xu          , Xu          , Xu          , Xu          , Xu          , Xu          , Xu          , Xu          , Xu          , Xu          , Xu          , Xu          , Xu          , Xu          , Xu          , Xu          , Xu          , Xu          , Xu          , Xu
Xu          , Xu          , Xu          , Xu          , Xu          , Xu          , Xu          , Xu          , Xu          , Xu          , Xu          , Xu          , Xu          , Xu          , Xu          , Xu          , Xu          , Uh          , Ur          , Ur          , Ur          , Ur          , Xu          , Xu          , Xu          , Xu          , Xu          , Xu          , Xu          , Xu          , Xu          , Xu          , Xu          , Xu          , Xu          , Xu          , Xu          , Xu          , Xu          , Xu          , Xu          , Xu          , Xu          , Xu
Xu          , Xu          , Xu          , Xu          , Xu          , Xu          , Xu          , Xu          , Xu          , Xu          , Xu          , Xu          , Xu          , Xu          , Xu          , Xu          , Uu          , Ur          , Ur          , Ur          , Uu^Uf       , Xu          , Xu          , Xu          , Xu          , Xu          , Xu          , Xu          , Xu          , Xu          , Xu          , Xu          , Xu          , Xu          , Xu          , Xu          , Xu          , Xu          , Xu          , Xu          , Xu          , Xu          , Xu          , Xu
